"filename", "language", "Dart", "Markdown", "comment", "blank", "total"
"c:\Users\dunca\Documents\development\apps\sayari\lib\__app\app_notes.md", "Markdown", 0, 8, 0, 7, 15
"c:\Users\dunca\Documents\development\apps\sayari\lib\__routing\routes.dart", "Dart", 46, 0, 9, 3, 58
"c:\Users\dunca\Documents\development\apps\sayari\lib\__styling\breakpoints.dart", "Dart", 9, 0, 0, 3, 12
"c:\Users\dunca\Documents\development\apps\sayari\lib\__styling\helpers.dart", "Dart", 54, 0, 3, 9, 66
"c:\Users\dunca\Documents\development\apps\sayari\lib\__styling\spacing.dart", "Dart", 56, 0, 6, 11, 73
"c:\Users\dunca\Documents\development\apps\sayari\lib\__styling\styler.dart", "Dart", 94, 0, 4, 29, 127
"c:\Users\dunca\Documents\development\apps\sayari\lib\__styling\theme.dart", "Dart", 67, 0, 1, 3, 71
"c:\Users\dunca\Documents\development\apps\sayari\lib\__styling\theme_btn.dart", "Dart", 28, 0, 0, 4, 32
"c:\Users\dunca\Documents\development\apps\sayari\lib\__styling\theme_menu.dart", "Dart", 72, 0, 5, 6, 83
"c:\Users\dunca\Documents\development\apps\sayari\lib\__styling\variables.dart", "Dart", 60, 0, 6, 14, 80
"c:\Users\dunca\Documents\development\apps\sayari\lib\_helpers\background_ops.dart", "Dart", 6, 0, 0, 3, 9
"c:\Users\dunca\Documents\development\apps\sayari\lib\_helpers\clipboard.dart", "Dart", 13, 0, 0, 3, 16
"c:\Users\dunca\Documents\development\apps\sayari\lib\_helpers\debug.dart", "Dart", 16, 0, 0, 5, 21
"c:\Users\dunca\Documents\development\apps\sayari\lib\_helpers\error_handler.dart", "Dart", 21, 0, 3, 6, 30
"c:\Users\dunca\Documents\development\apps\sayari\lib\_helpers\extentions\strings.dart", "Dart", 11, 0, 0, 2, 13
"c:\Users\dunca\Documents\development\apps\sayari\lib\_helpers\forms\form_validation_helper.dart", "Dart", 23, 0, 0, 6, 29
"c:\Users\dunca\Documents\development\apps\sayari\lib\_helpers\forms\regex_checks.dart", "Dart", 5, 0, 3, 2, 10
"c:\Users\dunca\Documents\development\apps\sayari\lib\_helpers\global.dart", "Dart", 23, 0, 0, 3, 26
"c:\Users\dunca\Documents\development\apps\sayari\lib\_helpers\helpers.dart", "Dart", 15, 0, 1, 7, 23
"c:\Users\dunca\Documents\development\apps\sayari\lib\_helpers\internet_connection.dart", "Dart", 4, 0, 26, 9, 39
"c:\Users\dunca\Documents\development\apps\sayari\lib\_helpers\keyboard.dart", "Dart", 11, 0, 0, 4, 15
"c:\Users\dunca\Documents\development\apps\sayari\lib\_helpers\navigation.dart", "Dart", 61, 0, 0, 15, 76
"c:\Users\dunca\Documents\development\apps\sayari\lib\_helpers\safe_run.dart", "Dart", 9, 0, 0, 2, 11
"c:\Users\dunca\Documents\development\apps\sayari\lib\_helpers\ui.dart", "Dart", 13, 0, 0, 5, 18
"c:\Users\dunca\Documents\development\apps\sayari\lib\_helpers\url_launcher.dart", "Dart", 19, 0, 2, 3, 24
"c:\Users\dunca\Documents\development\apps\sayari\lib\_models\features.dart", "Dart", 17, 0, 9, 7, 33
"c:\Users\dunca\Documents\development\apps\sayari\lib\_models\files.dart", "Dart", 15, 0, 0, 3, 18
"c:\Users\dunca\Documents\development\apps\sayari\lib\_models\item.dart", "Dart", 108, 0, 3, 12, 123
"c:\Users\dunca\Documents\development\apps\sayari\lib\_providers\_providers.dart", "Dart", 62, 0, 9, 8, 79
"c:\Users\dunca\Documents\development\apps\sayari\lib\_providers\focus.dart", "Dart", 12, 0, 0, 4, 16
"c:\Users\dunca\Documents\development\apps\sayari\lib\_providers\global.dart", "Dart", 21, 0, 4, 5, 30
"c:\Users\dunca\Documents\development\apps\sayari\lib\_providers\input.dart", "Dart", 81, 0, 5, 25, 111
"c:\Users\dunca\Documents\development\apps\sayari\lib\_providers\theme.dart", "Dart", 22, 0, 0, 5, 27
"c:\Users\dunca\Documents\development\apps\sayari\lib\_providers\views.dart", "Dart", 52, 0, 6, 12, 70
"c:\Users\dunca\Documents\development\apps\sayari\lib\_services\activity\activity_helper.dart", "Dart", 21, 0, 0, 4, 25
"c:\Users\dunca\Documents\development\apps\sayari\lib\_services\activity\listen\helpers.dart", "Dart", 24, 0, 2, 6, 32
"c:\Users\dunca\Documents\development\apps\sayari\lib\_services\activity\listen\listen_for_table_updates.dart", "Dart", 48, 0, 1, 7, 56
"c:\Users\dunca\Documents\development\apps\sayari\lib\_services\activity\listen\listen_for_user_updates.dart", "Dart", 32, 0, 2, 7, 41
"c:\Users\dunca\Documents\development\apps\sayari\lib\_services\activity\listen\variables.dart", "Dart", 4, 0, 0, 3, 7
"c:\Users\dunca\Documents\development\apps\sayari\lib\_services\activity\pending\pending_actions.dart", "Dart", 42, 0, 1, 6, 49
"c:\Users\dunca\Documents\development\apps\sayari\lib\_services\activity\pending\retry_pending_actions.dart", "Dart", 31, 0, 10, 4, 45
"c:\Users\dunca\Documents\development\apps\sayari\lib\_services\activity\save_activity.dart", "Dart", 9, 0, 30, 7, 46
"c:\Users\dunca\Documents\development\apps\sayari\lib\_services\firebase\_helpers\helpers.dart", "Dart", 42, 0, 0, 7, 49
"c:\Users\dunca\Documents\development\apps\sayari\lib\_services\firebase\_helpers\storage_errors.dart", "Dart", 21, 0, 4, 4, 29
"c:\Users\dunca\Documents\development\apps\sayari\lib\_services\firebase\database.dart", "Dart", 55, 0, 1, 18, 74
"c:\Users\dunca\Documents\development\apps\sayari\lib\_services\firebase\get_space_data.dart", "Dart", 86, 0, 0, 11, 97
"c:\Users\dunca\Documents\development\apps\sayari\lib\_services\firebase\get_user_data.dart", "Dart", 56, 0, 5, 5, 66
"c:\Users\dunca\Documents\development\apps\sayari\lib\_services\firebase\storage.dart", "Dart", 95, 0, 13, 16, 124
"c:\Users\dunca\Documents\development\apps\sayari\lib\_services\firebase\sync_from_cloud.dart", "Dart", 118, 0, 14, 15, 147
"c:\Users\dunca\Documents\development\apps\sayari\lib\_services\firebase\sync_to_cloud.dart", "Dart", 81, 0, 27, 10, 118
"c:\Users\dunca\Documents\development\apps\sayari\lib\_services\hive\get_data.dart", "Dart", 9, 0, 0, 3, 12
"c:\Users\dunca\Documents\development\apps\sayari\lib\_services\hive\load_boxes.dart", "Dart", 44, 0, 2, 7, 53
"c:\Users\dunca\Documents\development\apps\sayari\lib\_services\hive\local_storage_service.dart", "Dart", 14, 0, 1, 2, 17
"c:\Users\dunca\Documents\development\apps\sayari\lib\_services\hive\update.dart", "Dart", 44, 0, 15, 5, 64
"c:\Users\dunca\Documents\development\apps\sayari\lib\_services\notifications\act_on_notification.dart", "Dart", 4, 0, 0, 2, 6
"c:\Users\dunca\Documents\development\apps\sayari\lib\_services\notifications\create_notification.dart", "Dart", 69, 0, 0, 6, 75
"c:\Users\dunca\Documents\development\apps\sayari\lib\_services\notifications\init_notifications.dart", "Dart", 29, 0, 0, 4, 33
"c:\Users\dunca\Documents\development\apps\sayari\lib\_services\notifications\listen_for_notification.dart", "Dart", 7, 0, 0, 3, 10
"c:\Users\dunca\Documents\development\apps\sayari\lib\_services\notifications\notifications.dart", "Dart", 8, 0, 0, 2, 10
"c:\Users\dunca\Documents\development\apps\sayari\lib\_variables\colors.dart", "Dart", 27, 0, 0, 3, 30
"c:\Users\dunca\Documents\development\apps\sayari\lib\_variables\constants.dart", "Dart", 10, 0, 1, 4, 15
"c:\Users\dunca\Documents\development\apps\sayari\lib\_variables\emojis.dart", "Dart", 15, 0, 0, 1, 16
"c:\Users\dunca\Documents\development\apps\sayari\lib\_variables\features.dart", "Dart", 57, 0, 0, 7, 64
"c:\Users\dunca\Documents\development\apps\sayari\lib\_variables\global.dart", "Dart", 1, 0, 0, 1, 2
"c:\Users\dunca\Documents\development\apps\sayari\lib\_variables\intro_features.dart", "Dart", 13, 0, 0, 3, 16
"c:\Users\dunca\Documents\development\apps\sayari\lib\_variables\navigation.dart", "Dart", 7, 0, 0, 5, 12
"c:\Users\dunca\Documents\development\apps\sayari\lib\_variables\ui.dart", "Dart", 2, 0, 0, 2, 4
"c:\Users\dunca\Documents\development\apps\sayari\lib\_widgets\buttons\action.dart", "Dart", 24, 0, 0, 5, 29
"c:\Users\dunca\Documents\development\apps\sayari\lib\_widgets\buttons\button.dart", "Dart", 177, 0, 0, 7, 184
"c:\Users\dunca\Documents\development\apps\sayari\lib\_widgets\buttons\close.dart", "Dart", 25, 0, 0, 5, 30
"c:\Users\dunca\Documents\development\apps\sayari\lib\_widgets\dialogs\app_dialog.dart", "Dart", 98, 0, 7, 5, 110
"c:\Users\dunca\Documents\development\apps\sayari\lib\_widgets\dialogs\confirmation_dialog.dart", "Dart", 34, 0, 0, 4, 38
"c:\Users\dunca\Documents\development\apps\sayari\lib\_widgets\dialogs\dialog_select_date.dart", "Dart", 41, 0, 4, 4, 49
"c:\Users\dunca\Documents\development\apps\sayari\lib\_widgets\dialogs\dialog_select_groups.dart", "Dart", 82, 0, 0, 4, 86
"c:\Users\dunca\Documents\development\apps\sayari\lib\_widgets\forms\auth_input.dart", "Dart", 85, 0, 0, 8, 93
"c:\Users\dunca\Documents\development\apps\sayari\lib\_widgets\forms\input.dart", "Dart", 133, 0, 0, 7, 140
"c:\Users\dunca\Documents\development\apps\sayari\lib\_widgets\forms\numeric.dart", "Dart", 61, 0, 0, 5, 66
"c:\Users\dunca\Documents\development\apps\sayari\lib\_widgets\menu\confirmation.dart", "Dart", 49, 0, 3, 3, 55
"c:\Users\dunca\Documents\development\apps\sayari\lib\_widgets\menu\custom_menu.dart", "Dart", 432, 0, 44, 63, 539
"c:\Users\dunca\Documents\development\apps\sayari\lib\_widgets\menu\menu.dart", "Dart", 20, 0, 0, 6, 26
"c:\Users\dunca\Documents\development\apps\sayari\lib\_widgets\menu\menu_item.dart", "Dart", 119, 0, 0, 8, 127
"c:\Users\dunca\Documents\development\apps\sayari\lib\_widgets\others\checkbox.dart", "Dart", 59, 0, 0, 7, 66
"c:\Users\dunca\Documents\development\apps\sayari\lib\_widgets\others\color.dart", "Dart", 40, 0, 0, 6, 46
"c:\Users\dunca\Documents\development\apps\sayari\lib\_widgets\others\color_item.dart", "Dart", 38, 0, 0, 7, 45
"c:\Users\dunca\Documents\development\apps\sayari\lib\_widgets\others\color_menu.dart", "Dart", 35, 0, 5, 3, 43
"c:\Users\dunca\Documents\development\apps\sayari\lib\_widgets\others\empty_box.dart", "Dart", 38, 0, 3, 5, 46
"c:\Users\dunca\Documents\development\apps\sayari\lib\_widgets\others\icons.dart", "Dart", 35, 0, 0, 5, 40
"c:\Users\dunca\Documents\development\apps\sayari\lib\_widgets\others\images.dart", "Dart", 32, 0, 0, 4, 36
"c:\Users\dunca\Documents\development\apps\sayari\lib\_widgets\others\loader.dart", "Dart", 24, 0, 0, 5, 29
"c:\Users\dunca\Documents\development\apps\sayari\lib\_widgets\others\others\about_app.dart", "Dart", 36, 0, 6, 4, 46
"c:\Users\dunca\Documents\development\apps\sayari\lib\_widgets\others\others\confetti.dart", "Dart", 0, 0, 21, 7, 28
"c:\Users\dunca\Documents\development\apps\sayari\lib\_widgets\others\others\divider.dart", "Dart", 16, 0, 0, 5, 21
"c:\Users\dunca\Documents\development\apps\sayari\lib\_widgets\others\others\dry_intrinsic_size.dart", "Dart", 36, 0, 7, 7, 50
"c:\Users\dunca\Documents\development\apps\sayari\lib\_widgets\others\others\list_tile.dart", "Dart", 28, 0, 0, 5, 33
"c:\Users\dunca\Documents\development\apps\sayari\lib\_widgets\others\others\other.dart", "Dart", 6, 0, 0, 3, 9
"c:\Users\dunca\Documents\development\apps\sayari\lib\_widgets\others\others\scroll.dart", "Dart", 93, 0, 10, 23, 126
"c:\Users\dunca\Documents\development\apps\sayari\lib\_widgets\others\others\snap_scroll_physics.dart", "Dart", 75, 0, 8, 18, 101
"c:\Users\dunca\Documents\development\apps\sayari\lib\_widgets\others\others\swipe_detector.dart", "Dart", 72, 0, 1, 14, 87
"c:\Users\dunca\Documents\development\apps\sayari\lib\_widgets\others\others\sync_indicator.dart", "Dart", 49, 0, 0, 10, 59
"c:\Users\dunca\Documents\development\apps\sayari\lib\_widgets\others\sfcalendar.dart", "Dart", 141, 0, 12, 6, 159
"c:\Users\dunca\Documents\development\apps\sayari\lib\_widgets\others\snackbar.dart", "Dart", 42, 0, 5, 3, 50
"c:\Users\dunca\Documents\development\apps\sayari\lib\_widgets\others\svg.dart", "Dart", 32, 0, 0, 5, 37
"c:\Users\dunca\Documents\development\apps\sayari\lib\_widgets\others\text.dart", "Dart", 72, 0, 0, 8, 80
"c:\Users\dunca\Documents\development\apps\sayari\lib\_widgets\others\toast.dart", "Dart", 66, 0, 4, 5, 75
"c:\Users\dunca\Documents\development\apps\sayari\lib\_widgets\others\tooltip.dart", "Dart", 32, 0, 0, 5, 37
"c:\Users\dunca\Documents\development\apps\sayari\lib\_widgets\sheets\bottom_sheet.dart", "Dart", 121, 0, 11, 6, 138
"c:\Users\dunca\Documents\development\apps\sayari\lib\_widgets\sheets\floater.dart", "Dart", 122, 0, 17, 6, 145
"c:\Users\dunca\Documents\development\apps\sayari\lib\features\_home\_helpers\go_to_view.dart", "Dart", 8, 0, 0, 2, 10
"c:\Users\dunca\Documents\development\apps\sayari\lib\features\_home\_helpers\nav.dart", "Dart", 4, 0, 0, 2, 6
"c:\Users\dunca\Documents\development\apps\sayari\lib\features\_home\appbar.dart", "Dart", 77, 0, 9, 5, 91
"c:\Users\dunca\Documents\development\apps\sayari\lib\features\_home\drawer\drawer.dart", "Dart", 23, 0, 0, 4, 27
"c:\Users\dunca\Documents\development\apps\sayari\lib\features\_home\drawer\drawer_end.dart", "Dart", 23, 0, 0, 4, 27
"c:\Users\dunca\Documents\development\apps\sayari\lib\features\_home\home.dart", "Dart", 51, 0, 1, 9, 61
"c:\Users\dunca\Documents\development\apps\sayari\lib\features\_home\layout.dart", "Dart", 66, 0, 8, 5, 79
"c:\Users\dunca\Documents\development\apps\sayari\lib\features\_home\navbars\nav_item.dart", "Dart", 63, 0, 3, 4, 70
"c:\Users\dunca\Documents\development\apps\sayari\lib\features\_home\navbars\nav_menu.dart", "Dart", 38, 0, 5, 5, 48
"c:\Users\dunca\Documents\development\apps\sayari\lib\features\_home\navbars\navbar_horizontal.dart", "Dart", 45, 0, 3, 4, 52
"c:\Users\dunca\Documents\development\apps\sayari\lib\features\_home\navbars\navbar_vertical.dart", "Dart", 47, 0, 6, 5, 58
"c:\Users\dunca\Documents\development\apps\sayari\lib\features\_home\navbars\pinned_menu.dart", "Dart", 14, 0, 6, 3, 23
"c:\Users\dunca\Documents\development\apps\sayari\lib\features\_home\navbars\pinned_option.dart", "Dart", 35, 0, 0, 6, 41
"c:\Users\dunca\Documents\development\apps\sayari\lib\features\_home\panel\panel.dart", "Dart", 66, 0, 8, 5, 79
"c:\Users\dunca\Documents\development\apps\sayari\lib\features\_home\panel\toggle.dart", "Dart", 24, 0, 0, 4, 28
"c:\Users\dunca\Documents\development\apps\sayari\lib\features\_home\panel\user_options.dart", "Dart", 32, 0, 24, 4, 60
"c:\Users\dunca\Documents\development\apps\sayari\lib\features\_home\space.dart", "Dart", 86, 0, 10, 6, 102
"c:\Users\dunca\Documents\development\apps\sayari\lib\features\_home\view.dart", "Dart", 34, 0, 2, 5, 41
"c:\Users\dunca\Documents\development\apps\sayari\lib\features\_home\w\fab.dart", "Dart", 41, 0, 0, 5, 46
"c:\Users\dunca\Documents\development\apps\sayari\lib\features\_notes\_helpers\chosen.dart", "Dart", 43, 0, 0, 9, 52
"c:\Users\dunca\Documents\development\apps\sayari\lib\features\_notes\_helpers\compare_data.dart", "Dart", 28, 0, 8, 8, 44
"c:\Users\dunca\Documents\development\apps\sayari\lib\features\_notes\_helpers\create_item.dart", "Dart", 55, 0, 5, 10, 70
"c:\Users\dunca\Documents\development\apps\sayari\lib\features\_notes\_helpers\delete_item.dart", "Dart", 25, 0, 0, 4, 29
"c:\Users\dunca\Documents\development\apps\sayari\lib\features\_notes\_helpers\edit_item.dart", "Dart", 68, 0, 8, 10, 86
"c:\Users\dunca\Documents\development\apps\sayari\lib\features\_notes\_helpers\helpers.dart", "Dart", 15, 0, 0, 4, 19
"c:\Users\dunca\Documents\development\apps\sayari\lib\features\_notes\_helpers\ontap.dart", "Dart", 33, 0, 1, 6, 40
"c:\Users\dunca\Documents\development\apps\sayari\lib\features\_notes\_helpers\order_items.dart", "Dart", 47, 0, 2, 5, 54
"c:\Users\dunca\Documents\development\apps\sayari\lib\features\_notes\_helpers\prepare.dart", "Dart", 20, 0, 0, 4, 24
"c:\Users\dunca\Documents\development\apps\sayari\lib\features\_notes\_helpers\quick_edit.dart", "Dart", 43, 0, 1, 9, 53
"c:\Users\dunca\Documents\development\apps\sayari\lib\features\_notes\_helpers\save_quicknote.dart", "Dart", 41, 0, 0, 3, 44
"c:\Users\dunca\Documents\development\apps\sayari\lib\features\_notes\_helpers\validation.dart", "Dart", 44, 0, 1, 10, 55
"c:\Users\dunca\Documents\development\apps\sayari\lib\features\_notes\blog\actions.dart", "Dart", 54, 0, 4, 6, 64
"c:\Users\dunca\Documents\development\apps\sayari\lib\features\_notes\blog\blog_body.dart", "Dart", 59, 0, 8, 6, 73
"c:\Users\dunca\Documents\development\apps\sayari\lib\features\_notes\blog\blog_info.dart", "Dart", 44, 0, 7, 6, 57
"c:\Users\dunca\Documents\development\apps\sayari\lib\features\_notes\layout\column_layout.dart", "Dart", 52, 0, 0, 5, 57
"c:\Users\dunca\Documents\development\apps\sayari\lib\features\_notes\layout\grid_layout.dart", "Dart", 51, 0, 0, 6, 57
"c:\Users\dunca\Documents\development\apps\sayari\lib\features\_notes\layout\layout_button.dart", "Dart", 62, 0, 2, 4, 68
"c:\Users\dunca\Documents\development\apps\sayari\lib\features\_notes\layout\list_layout.dart", "Dart", 45, 0, 0, 5, 50
"c:\Users\dunca\Documents\development\apps\sayari\lib\features\_notes\note.dart", "Dart", 107, 0, 2, 6, 115
"c:\Users\dunca\Documents\development\apps\sayari\lib\features\_notes\note_sheet.dart", "Dart", 100, 0, 11, 3, 114
"c:\Users\dunca\Documents\development\apps\sayari\lib\features\_notes\notes_view.dart", "Dart", 38, 0, 0, 7, 45
"c:\Users\dunca\Documents\development\apps\sayari\lib\features\_notes\quicknote\formatting_btn.dart", "Dart", 23, 0, 0, 5, 28
"c:\Users\dunca\Documents\development\apps\sayari\lib\features\_notes\quicknote\quick_note.dart", "Dart", 80, 0, 6, 5, 91
"c:\Users\dunca\Documents\development\apps\sayari\lib\features\_notes\quicknote\save_quicknote_btn.dart", "Dart", 24, 0, 0, 5, 29
"c:\Users\dunca\Documents\development\apps\sayari\lib\features\_notes\quill\editor.dart", "Dart", 52, 0, 0, 6, 58
"c:\Users\dunca\Documents\development\apps\sayari\lib\features\_notes\quill\editor_style.dart", "Dart", 177, 0, 0, 7, 184
"c:\Users\dunca\Documents\development\apps\sayari\lib\features\_notes\quill\embed_divider.dart", "Dart", 43, 0, 1, 10, 54
"c:\Users\dunca\Documents\development\apps\sayari\lib\features\_notes\quill\embed_image.dart", "Dart", 48, 0, 0, 9, 57
"c:\Users\dunca\Documents\development\apps\sayari\lib\features\_notes\quill\overview_editor.dart", "Dart", 33, 0, 0, 6, 39
"c:\Users\dunca\Documents\development\apps\sayari\lib\features\_notes\quill\toolbar.dart", "Dart", 120, 0, 21, 6, 147
"c:\Users\dunca\Documents\development\apps\sayari\lib\features\_notes\state\quill.dart", "Dart", 35, 0, 0, 8, 43
"c:\Users\dunca\Documents\development\apps\sayari\lib\features\_notes\state\selection.dart", "Dart", 24, 0, 1, 7, 32
"c:\Users\dunca\Documents\development\apps\sayari\lib\features\_notes\w\date.dart", "Dart", 103, 0, 10, 6, 119
"c:\Users\dunca\Documents\development\apps\sayari\lib\features\_notes\w\details.dart", "Dart", 33, 0, 6, 5, 44
"c:\Users\dunca\Documents\development\apps\sayari\lib\features\_notes\w\emoji.dart", "Dart", 23, 0, 0, 5, 28
"c:\Users\dunca\Documents\development\apps\sayari\lib\features\_notes\w\emoji_menu.dart", "Dart", 47, 0, 7, 3, 57
"c:\Users\dunca\Documents\development\apps\sayari\lib\features\_notes\w\footer.dart", "Dart", 26, 0, 2, 5, 33
"c:\Users\dunca\Documents\development\apps\sayari\lib\features\_notes\w\formatting_btn.dart", "Dart", 25, 0, 0, 5, 30
"c:\Users\dunca\Documents\development\apps\sayari\lib\features\_notes\w\header.dart", "Dart", 63, 0, 9, 5, 77
"c:\Users\dunca\Documents\development\apps\sayari\lib\features\_notes\w\last_edit.dart", "Dart", 23, 0, 0, 5, 28
"c:\Users\dunca\Documents\development\apps\sayari\lib\features\_notes\w\list_item.dart", "Dart", 47, 0, 5, 5, 57
"c:\Users\dunca\Documents\development\apps\sayari\lib\features\_notes\w\new.dart", "Dart", 52, 0, 3, 4, 59
"c:\Users\dunca\Documents\development\apps\sayari\lib\features\_notes\w\note_options.dart", "Dart", 26, 0, 4, 5, 35
"c:\Users\dunca\Documents\development\apps\sayari\lib\features\_notes\w\picker_type.dart", "Dart", 78, 0, 6, 7, 91
"c:\Users\dunca\Documents\development\apps\sayari\lib\features\_notes\w\pinned.dart", "Dart", 33, 0, 0, 6, 39
"c:\Users\dunca\Documents\development\apps\sayari\lib\features\_notes\w\selector.dart", "Dart", 74, 0, 0, 7, 81
"c:\Users\dunca\Documents\development\apps\sayari\lib\features\_notes\w\shared_info.dart", "Dart", 56, 0, 3, 5, 64
"c:\Users\dunca\Documents\development\apps\sayari\lib\features\_notes\w\templates_menu.dart", "Dart", 13, 0, 2, 3, 18
"c:\Users\dunca\Documents\development\apps\sayari\lib\features\_notes\w_actions\actions.dart", "Dart", 153, 0, 15, 6, 174
"c:\Users\dunca\Documents\development\apps\sayari\lib\features\_notes\w_actions\input_actions.dart", "Dart", 96, 0, 10, 5, 111
"c:\Users\dunca\Documents\development\apps\sayari\lib\features\_notes\w_actions\input_actions_more.dart", "Dart", 69, 0, 6, 5, 80
"c:\Users\dunca\Documents\development\apps\sayari\lib\features\_notes\w_actions\item_selection.dart", "Dart", 207, 0, 36, 5, 248
"c:\Users\dunca\Documents\development\apps\sayari\lib\features\_notes\w_actions\item_selection_more.dart", "Dart", 51, 0, 3, 5, 59
"c:\Users\dunca\Documents\development\apps\sayari\lib\features\_spaces\_helpers\add_space.dart", "Dart", 40, 0, 0, 4, 44
"c:\Users\dunca\Documents\development\apps\sayari\lib\features\_spaces\_helpers\checks_space.dart", "Dart", 35, 0, 0, 7, 42
"c:\Users\dunca\Documents\development\apps\sayari\lib\features\_spaces\_helpers\common.dart", "Dart", 29, 0, 0, 5, 34
"c:\Users\dunca\Documents\development\apps\sayari\lib\features\_spaces\_helpers\create_space.dart", "Dart", 34, 0, 19, 3, 56
"c:\Users\dunca\Documents\development\apps\sayari\lib\features\_spaces\_helpers\delete_space.dart", "Dart", 74, 0, 27, 6, 107
"c:\Users\dunca\Documents\development\apps\sayari\lib\features\_spaces\_helpers\helpers.dart", "Dart", 20, 0, 0, 4, 24
"c:\Users\dunca\Documents\development\apps\sayari\lib\features\_spaces\_helpers\member_helpers.dart", "Dart", 87, 0, 0, 8, 95
"c:\Users\dunca\Documents\development\apps\sayari\lib\features\_spaces\_helpers\select_space.dart", "Dart", 27, 0, 6, 5, 38
"c:\Users\dunca\Documents\development\apps\sayari\lib\features\_spaces\_helpers\space_names.dart", "Dart", 38, 0, 0, 8, 46
"c:\Users\dunca\Documents\development\apps\sayari\lib\features\_spaces\manager\_w\creator_options.dart", "Dart", 51, 0, 7, 4, 62
"c:\Users\dunca\Documents\development\apps\sayari\lib\features\_spaces\manager\_w\dialog_add_space.dart", "Dart", 27, 0, 0, 4, 31
"c:\Users\dunca\Documents\development\apps\sayari\lib\features\_spaces\manager\_w\dialog_create_group.dart", "Dart", 27, 0, 0, 4, 31
"c:\Users\dunca\Documents\development\apps\sayari\lib\features\_spaces\manager\_w\group_list.dart", "Dart", 25, 0, 0, 4, 29
"c:\Users\dunca\Documents\development\apps\sayari\lib\features\_spaces\manager\_w\group_options.dart", "Dart", 26, 0, 2, 5, 33
"c:\Users\dunca\Documents\development\apps\sayari\lib\features\_spaces\manager\_w\group_tile.dart", "Dart", 27, 0, 0, 6, 33
"c:\Users\dunca\Documents\development\apps\sayari\lib\features\_spaces\manager\_w\space_list.dart", "Dart", 30, 0, 0, 4, 34
"c:\Users\dunca\Documents\development\apps\sayari\lib\features\_spaces\manager\_w\space_options.dart", "Dart", 78, 0, 6, 8, 92
"c:\Users\dunca\Documents\development\apps\sayari\lib\features\_spaces\manager\_w\space_tile.dart", "Dart", 81, 0, 10, 9, 100
"c:\Users\dunca\Documents\development\apps\sayari\lib\features\_spaces\manager\_w\tile.dart", "Dart", 60, 0, 0, 5, 65
"c:\Users\dunca\Documents\development\apps\sayari\lib\features\_spaces\manager\manager.dart", "Dart", 29, 0, 2, 4, 35
"c:\Users\dunca\Documents\development\apps\sayari\lib\features\_spaces\new_space\_w\description.dart", "Dart", 31, 0, 4, 4, 39
"c:\Users\dunca\Documents\development\apps\sayari\lib\features\_spaces\new_space\_w\group.dart", "Dart", 64, 0, 3, 5, 72
"c:\Users\dunca\Documents\development\apps\sayari\lib\features\_spaces\new_space\_w\header.dart", "Dart", 27, 0, 3, 5, 35
"c:\Users\dunca\Documents\development\apps\sayari\lib\features\_spaces\new_space\_w\title.dart", "Dart", 23, 0, 0, 5, 28
"c:\Users\dunca\Documents\development\apps\sayari\lib\features\_spaces\new_space\space_sheet.dart", "Dart", 34, 0, 5, 3, 42
"c:\Users\dunca\Documents\development\apps\sayari\lib\features\_spaces\overview\_w\activity_sheet.dart", "Dart", 57, 0, 5, 4, 66
"c:\Users\dunca\Documents\development\apps\sayari\lib\features\_spaces\overview\_w\add_member.dart", "Dart", 25, 0, 0, 4, 29
"c:\Users\dunca\Documents\development\apps\sayari\lib\features\_spaces\overview\_w\delete_btn.dart", "Dart", 27, 0, 0, 4, 31
"c:\Users\dunca\Documents\development\apps\sayari\lib\features\_spaces\overview\_w\dialog_space_activity.dart", "Dart", 12, 0, 0, 2, 14
"c:\Users\dunca\Documents\development\apps\sayari\lib\features\_spaces\overview\_w\member_chip.dart", "Dart", 75, 0, 4, 6, 85
"c:\Users\dunca\Documents\development\apps\sayari\lib\features\_spaces\overview\_w\members.dart", "Dart", 68, 0, 5, 7, 80
"c:\Users\dunca\Documents\development\apps\sayari\lib\features\_spaces\overview\_w\notification_item.dart", "Dart", 25, 0, 0, 5, 30
"c:\Users\dunca\Documents\development\apps\sayari\lib\features\_spaces\overview\_w\notifications.dart", "Dart", 39, 0, 9, 3, 51
"c:\Users\dunca\Documents\development\apps\sayari\lib\features\_spaces\overview\_w\space_action_button.dart", "Dart", 30, 0, 0, 3, 33
"c:\Users\dunca\Documents\development\apps\sayari\lib\features\_spaces\overview\_w\space_activity_tile.dart", "Dart", 27, 0, 0, 4, 31
"c:\Users\dunca\Documents\development\apps\sayari\lib\features\_spaces\overview\_w\space_name.dart", "Dart", 21, 0, 0, 4, 25
"c:\Users\dunca\Documents\development\apps\sayari\lib\features\_spaces\overview\_w\space_notfications_tile.dart", "Dart", 25, 0, 0, 5, 30
"c:\Users\dunca\Documents\development\apps\sayari\lib\features\_spaces\overview\_w\space_owner_tile.dart", "Dart", 42, 0, 0, 5, 47
"c:\Users\dunca\Documents\development\apps\sayari\lib\features\_spaces\overview\overview_sheet.dart", "Dart", 116, 0, 5, 6, 127
"c:\Users\dunca\Documents\development\apps\sayari\lib\features\_spaces\published\button.dart", "Dart", 44, 0, 3, 5, 52
"c:\Users\dunca\Documents\development\apps\sayari\lib\features\_spaces\published\details.dart", "Dart", 125, 0, 7, 7, 139
"c:\Users\dunca\Documents\development\apps\sayari\lib\features\_spaces\published\shared\cover.dart", "Dart", 46, 0, 0, 7, 53
"c:\Users\dunca\Documents\development\apps\sayari\lib\features\_spaces\published\shared\shared.dart", "Dart", 60, 0, 5, 5, 70
"c:\Users\dunca\Documents\development\apps\sayari\lib\features\_spaces\published\shared\shared_intro.dart", "Dart", 63, 0, 4, 5, 72
"c:\Users\dunca\Documents\development\apps\sayari\lib\features\_spaces\var\variables.dart", "Dart", 2, 0, 0, 1, 3
"c:\Users\dunca\Documents\development\apps\sayari\lib\features\ai\_helpers\helpers.dart", "Dart", 0, 0, 0, 2, 2
"c:\Users\dunca\Documents\development\apps\sayari\lib\features\ai\_helpers\prompt.dart", "Dart", 1, 0, 0, 1, 2
"c:\Users\dunca\Documents\development\apps\sayari\lib\features\ai\ai_bar.dart", "Dart", 51, 0, 0, 4, 55
"c:\Users\dunca\Documents\development\apps\sayari\lib\features\ai\ai_btn.dart", "Dart", 21, 0, 0, 4, 25
"c:\Users\dunca\Documents\development\apps\sayari\lib\features\ai\ai_sheet.dart", "Dart", 21, 0, 5, 3, 29
"c:\Users\dunca\Documents\development\apps\sayari\lib\features\auth\_helpers\anonymous.dart", "Dart", 4, 0, 3, 2, 9
"c:\Users\dunca\Documents\development\apps\sayari\lib\features\auth\_helpers\apple.dart", "Dart", 2, 0, 28, 8, 38
"c:\Users\dunca\Documents\development\apps\sayari\lib\features\auth\_helpers\auth_error_handler.dart", "Dart", 48, 0, 10, 6, 64
"c:\Users\dunca\Documents\development\apps\sayari\lib\features\auth\_helpers\email_signin.dart", "Dart", 37, 0, 4, 5, 46
"c:\Users\dunca\Documents\development\apps\sayari\lib\features\auth\_helpers\email_signup.dart", "Dart", 48, 0, 10, 5, 63
"c:\Users\dunca\Documents\development\apps\sayari\lib\features\auth\_helpers\google.dart", "Dart", 15, 0, 8, 10, 33
"c:\Users\dunca\Documents\development\apps\sayari\lib\features\auth\_helpers\reset_password.dart", "Dart", 17, 0, 0, 4, 21
"c:\Users\dunca\Documents\development\apps\sayari\lib\features\auth\_helpers\sign_out.dart", "Dart", 13, 0, 0, 3, 16
"c:\Users\dunca\Documents\development\apps\sayari\lib\features\auth\_helpers\user_details_helper.dart", "Dart", 17, 0, 0, 4, 21
"c:\Users\dunca\Documents\development\apps\sayari\lib\features\auth\auth_screen.dart", "Dart", 289, 0, 28, 13, 330
"c:\Users\dunca\Documents\development\apps\sayari\lib\features\auth\button.dart", "Dart", 41, 0, 0, 5, 46
"c:\Users\dunca\Documents\development\apps\sayari\lib\features\auth\intro.dart", "Dart", 63, 0, 2, 5, 70
"c:\Users\dunca\Documents\development\apps\sayari\lib\features\bookings\_w\booking.dart", "Dart", 73, 0, 11, 5, 89
"c:\Users\dunca\Documents\development\apps\sayari\lib\features\bookings\_w\bookings_list.dart", "Dart", 186, 0, 15, 7, 208
"c:\Users\dunca\Documents\development\apps\sayari\lib\features\bookings\_w\change_date.dart", "Dart", 130, 0, 11, 8, 149
"c:\Users\dunca\Documents\development\apps\sayari\lib\features\bookings\_w\copy_link.dart", "Dart", 36, 0, 0, 5, 41
"c:\Users\dunca\Documents\development\apps\sayari\lib\features\bookings\_w\date_times.dart", "Dart", 122, 0, 13, 5, 140
"c:\Users\dunca\Documents\development\apps\sayari\lib\features\bookings\_w\header.dart", "Dart", 29, 0, 0, 5, 34
"c:\Users\dunca\Documents\development\apps\sayari\lib\features\bookings\_w\overview.dart", "Dart", 61, 0, 4, 5, 70
"c:\Users\dunca\Documents\development\apps\sayari\lib\features\bookings\_w_shared\body.dart", "Dart", 48, 0, 8, 6, 62
"c:\Users\dunca\Documents\development\apps\sayari\lib\features\bookings\_w_shared\booker.dart", "Dart", 156, 0, 12, 12, 180
"c:\Users\dunca\Documents\development\apps\sayari\lib\features\bookings\_w_shared\date.dart", "Dart", 96, 0, 6, 4, 106
"c:\Users\dunca\Documents\development\apps\sayari\lib\features\bookings\_w_shared\intro.dart", "Dart", 56, 0, 4, 6, 66
"c:\Users\dunca\Documents\development\apps\sayari\lib\features\bookings\_w_shared\time.dart", "Dart", 99, 0, 7, 5, 111
"c:\Users\dunca\Documents\development\apps\sayari\lib\features\calendar\_helpers\copy.dart", "Dart", 29, 0, 0, 4, 33
"c:\Users\dunca\Documents\development\apps\sayari\lib\features\calendar\_helpers\date_time\checks_date.dart", "Dart", 11, 0, 0, 4, 15
"c:\Users\dunca\Documents\development\apps\sayari\lib\features\calendar\_helpers\date_time\date_info.dart", "Dart", 85, 0, 2, 17, 104
"c:\Users\dunca\Documents\development\apps\sayari\lib\features\calendar\_helpers\date_time\get_week_no.dart", "Dart", 16, 0, 2, 3, 21
"c:\Users\dunca\Documents\development\apps\sayari\lib\features\calendar\_helpers\date_time\jump_to_date.dart", "Dart", 27, 0, 0, 4, 31
"c:\Users\dunca\Documents\development\apps\sayari\lib\features\calendar\_helpers\date_time\misc.dart", "Dart", 124, 0, 1, 22, 147
"c:\Users\dunca\Documents\development\apps\sayari\lib\features\calendar\_helpers\date_time\months.dart", "Dart", 23, 0, 0, 6, 29
"c:\Users\dunca\Documents\development\apps\sayari\lib\features\calendar\_helpers\date_time\weeks.dart", "Dart", 81, 0, 0, 3, 84
"c:\Users\dunca\Documents\development\apps\sayari\lib\features\calendar\_helpers\delete.dart", "Dart", 9, 0, 0, 2, 11
"c:\Users\dunca\Documents\development\apps\sayari\lib\features\calendar\_helpers\go_to_today.dart", "Dart", 21, 0, 1, 3, 25
"c:\Users\dunca\Documents\development\apps\sayari\lib\features\calendar\_helpers\helpers.dart", "Dart", 16, 0, 0, 4, 20
"c:\Users\dunca\Documents\development\apps\sayari\lib\features\calendar\_helpers\prepare.dart", "Dart", 18, 0, 0, 4, 22
"c:\Users\dunca\Documents\development\apps\sayari\lib\features\calendar\_helpers\sort.dart", "Dart", 12, 0, 0, 5, 17
"c:\Users\dunca\Documents\development\apps\sayari\lib\features\calendar\_helpers\swipe.dart", "Dart", 30, 0, 0, 7, 37
"c:\Users\dunca\Documents\development\apps\sayari\lib\features\calendar\_vars\date_time.dart", "Dart", 132, 0, 4, 8, 144
"c:\Users\dunca\Documents\development\apps\sayari\lib\features\calendar\_vars\variables.dart", "Dart", 23, 0, 0, 1, 24
"c:\Users\dunca\Documents\development\apps\sayari\lib\features\calendar\daily\daily.dart", "Dart", 111, 0, 6, 7, 124
"c:\Users\dunca\Documents\development\apps\sayari\lib\features\calendar\daily\daily_time_divider.dart", "Dart", 12, 0, 0, 4, 16
"c:\Users\dunca\Documents\development\apps\sayari\lib\features\calendar\due_today\due_today.dart", "Dart", 74, 0, 6, 7, 87
"c:\Users\dunca\Documents\development\apps\sayari\lib\features\calendar\info_header.dart", "Dart", 94, 0, 8, 5, 107
"c:\Users\dunca\Documents\development\apps\sayari\lib\features\calendar\monthly\day_label.dart", "Dart", 32, 0, 0, 6, 38
"c:\Users\dunca\Documents\development\apps\sayari\lib\features\calendar\monthly\list_of_sessions.dart", "Dart", 33, 0, 0, 6, 39
"c:\Users\dunca\Documents\development\apps\sayari\lib\features\calendar\monthly\monthly.dart", "Dart", 116, 0, 6, 7, 129
"c:\Users\dunca\Documents\development\apps\sayari\lib\features\calendar\monthly\weekday_labels.dart", "Dart", 44, 0, 0, 5, 49
"c:\Users\dunca\Documents\development\apps\sayari\lib\features\calendar\new_session\_w\about.dart", "Dart", 26, 0, 4, 4, 34
"c:\Users\dunca\Documents\development\apps\sayari\lib\features\calendar\new_session\_w\color.dart", "Dart", 20, 0, 0, 4, 24
"c:\Users\dunca\Documents\development\apps\sayari\lib\features\calendar\new_session\_w\date.dart", "Dart", 98, 0, 13, 4, 115
"c:\Users\dunca\Documents\development\apps\sayari\lib\features\calendar\new_session\_w\date_item.dart", "Dart", 32, 0, 1, 5, 38
"c:\Users\dunca\Documents\development\apps\sayari\lib\features\calendar\new_session\_w\date_range_dialog.dart", "Dart", 129, 0, 10, 3, 142
"c:\Users\dunca\Documents\development\apps\sayari\lib\features\calendar\new_session\_w\files.dart", "Dart", 46, 0, 7, 4, 57
"c:\Users\dunca\Documents\development\apps\sayari\lib\features\calendar\new_session\_w\lead.dart", "Dart", 26, 0, 4, 4, 34
"c:\Users\dunca\Documents\development\apps\sayari\lib\features\calendar\new_session\_w\reminder_item.dart", "Dart", 79, 0, 5, 6, 90
"c:\Users\dunca\Documents\development\apps\sayari\lib\features\calendar\new_session\_w\reminders.dart", "Dart", 67, 0, 6, 5, 78
"c:\Users\dunca\Documents\development\apps\sayari\lib\features\calendar\new_session\_w\time.dart", "Dart", 94, 0, 10, 5, 109
"c:\Users\dunca\Documents\development\apps\sayari\lib\features\calendar\new_session\_w\type.dart", "Dart", 21, 0, 1, 4, 26
"c:\Users\dunca\Documents\development\apps\sayari\lib\features\calendar\new_session\_w\venue.dart", "Dart", 26, 0, 4, 4, 34
"c:\Users\dunca\Documents\development\apps\sayari\lib\features\calendar\new_session\session_dialog.dart", "Dart", 93, 0, 8, 4, 105
"c:\Users\dunca\Documents\development\apps\sayari\lib\features\calendar\overview\overview.dart", "Dart", 80, 0, 12, 4, 96
"c:\Users\dunca\Documents\development\apps\sayari\lib\features\calendar\overview\session_info_tile.dart", "Dart", 24, 0, 0, 5, 29
"c:\Users\dunca\Documents\development\apps\sayari\lib\features\calendar\overview\session_options.dart", "Dart", 58, 0, 5, 5, 68
"c:\Users\dunca\Documents\development\apps\sayari\lib\features\calendar\overview\session_reminders.dart", "Dart", 37, 0, 3, 6, 46
"c:\Users\dunca\Documents\development\apps\sayari\lib\features\calendar\overview\session_time.dart", "Dart", 28, 0, 3, 6, 37
"c:\Users\dunca\Documents\development\apps\sayari\lib\features\calendar\overview\session_type.dart", "Dart", 26, 0, 2, 5, 33
"c:\Users\dunca\Documents\development\apps\sayari\lib\features\calendar\session_view.dart", "Dart", 23, 0, 0, 5, 28
"c:\Users\dunca\Documents\development\apps\sayari\lib\features\calendar\state\datetime.dart", "Dart", 55, 0, 1, 14, 70
"c:\Users\dunca\Documents\development\apps\sayari\lib\features\calendar\var\variables.dart", "Dart", 1, 0, 0, 1, 2
"c:\Users\dunca\Documents\development\apps\sayari\lib\features\calendar\w\daily_box.dart", "Dart", 96, 0, 8, 5, 109
"c:\Users\dunca\Documents\development\apps\sayari\lib\features\calendar\w\monthly_box.dart", "Dart", 33, 0, 0, 5, 38
"c:\Users\dunca\Documents\development\apps\sayari\lib\features\calendar\w\sessions_list_menu.dart", "Dart", 67, 0, 8, 5, 80
"c:\Users\dunca\Documents\development\apps\sayari\lib\features\calendar\w\view_chooser.dart", "Dart", 57, 0, 2, 4, 63
"c:\Users\dunca\Documents\development\apps\sayari\lib\features\calendar\w\weekly_box.dart", "Dart", 70, 0, 3, 6, 79
"c:\Users\dunca\Documents\development\apps\sayari\lib\features\calendar\weekly\day_labels.dart", "Dart", 74, 0, 6, 5, 85
"c:\Users\dunca\Documents\development\apps\sayari\lib\features\calendar\weekly\weekly.dart", "Dart", 133, 0, 12, 8, 153
"c:\Users\dunca\Documents\development\apps\sayari\lib\features\calendar\yearly\month.dart", "Dart", 27, 0, 0, 5, 32
"c:\Users\dunca\Documents\development\apps\sayari\lib\features\calendar\yearly\title.dart", "Dart", 32, 0, 0, 6, 38
"c:\Users\dunca\Documents\development\apps\sayari\lib\features\calendar\yearly\yearly_view.dart", "Dart", 128, 0, 3, 8, 139
"c:\Users\dunca\Documents\development\apps\sayari\lib\features\chat\_helpers\delete.dart", "Dart", 26, 0, 1, 3, 30
"c:\Users\dunca\Documents\development\apps\sayari\lib\features\chat\_helpers\helpers.dart", "Dart", 9, 0, 0, 3, 12
"c:\Users\dunca\Documents\development\apps\sayari\lib\features\chat\_helpers\jump_to_date.dart", "Dart", 14, 0, 0, 3, 17
"c:\Users\dunca\Documents\development\apps\sayari\lib\features\chat\_helpers\send.dart", "Dart", 35, 0, 0, 6, 41
"c:\Users\dunca\Documents\development\apps\sayari\lib\features\chat\chat_view.dart", "Dart", 100, 0, 3, 10, 113
"c:\Users\dunca\Documents\development\apps\sayari\lib\features\chat\input.dart", "Dart", 119, 0, 11, 6, 136
"c:\Users\dunca\Documents\development\apps\sayari\lib\features\chat\state\chat.dart", "Dart", 11, 0, 0, 4, 15
"c:\Users\dunca\Documents\development\apps\sayari\lib\features\chat\w\actions.dart", "Dart", 31, 0, 0, 5, 36
"c:\Users\dunca\Documents\development\apps\sayari\lib\features\chat\w\actions_menu.dart", "Dart", 35, 0, 20, 3, 58
"c:\Users\dunca\Documents\development\apps\sayari\lib\features\chat\w\bubble_incoming.dart", "Dart", 126, 0, 10, 9, 145
"c:\Users\dunca\Documents\development\apps\sayari\lib\features\chat\w\bubble_sent.dart", "Dart", 108, 0, 12, 11, 131
"c:\Users\dunca\Documents\development\apps\sayari\lib\features\chat\w\chat_date.dart", "Dart", 39, 0, 0, 5, 44
"c:\Users\dunca\Documents\development\apps\sayari\lib\features\chat\w\filters.dart", "Dart", 52, 0, 3, 8, 63
"c:\Users\dunca\Documents\development\apps\sayari\lib\features\chat\w\formatting_btn.dart", "Dart", 23, 0, 0, 5, 28
"c:\Users\dunca\Documents\development\apps\sayari\lib\features\chat\w\scroll_btn.dart", "Dart", 33, 0, 11, 8, 52
"c:\Users\dunca\Documents\development\apps\sayari\lib\features\chat\w\send_btn.dart", "Dart", 23, 0, 0, 5, 28
"c:\Users\dunca\Documents\development\apps\sayari\lib\features\chat\w\var.dart", "Dart", 2, 0, 0, 2, 4
"c:\Users\dunca\Documents\development\apps\sayari\lib\features\error\error_screen.dart", "Dart", 72, 0, 3, 4, 79
"c:\Users\dunca\Documents\development\apps\sayari\lib\features\explore\explore_box.dart", "Dart", 51, 0, 5, 5, 61
"c:\Users\dunca\Documents\development\apps\sayari\lib\features\explore\explore_sheet.dart", "Dart", 50, 0, 8, 3, 61
"c:\Users\dunca\Documents\development\apps\sayari\lib\features\files\_helpers\cached.dart", "Dart", 35, 0, 2, 6, 43
"c:\Users\dunca\Documents\development\apps\sayari\lib\features\files\_helpers\download.dart", "Dart", 82, 0, 11, 7, 100
"c:\Users\dunca\Documents\development\apps\sayari\lib\features\files\_helpers\handler.dart", "Dart", 56, 0, 10, 5, 71
"c:\Users\dunca\Documents\development\apps\sayari\lib\features\files\_helpers\helper.dart", "Dart", 45, 0, 1, 11, 57
"c:\Users\dunca\Documents\development\apps\sayari\lib\features\files\_helpers\pdf.dart", "Dart", 0, 0, 12, 2, 14
"c:\Users\dunca\Documents\development\apps\sayari\lib\features\files\_helpers\upload.dart", "Dart", 47, 0, 0, 9, 56
"c:\Users\dunca\Documents\development\apps\sayari\lib\features\files\file.dart", "Dart", 50, 0, 8, 8, 66
"c:\Users\dunca\Documents\development\apps\sayari\lib\features\files\file_list.dart", "Dart", 106, 0, 9, 8, 123
"c:\Users\dunca\Documents\development\apps\sayari\lib\features\files\file_list_overview.dart", "Dart", 32, 0, 0, 5, 37
"c:\Users\dunca\Documents\development\apps\sayari\lib\features\files\image.dart", "Dart", 148, 0, 16, 11, 175
"c:\Users\dunca\Documents\development\apps\sayari\lib\features\files\image_extended.dart", "Dart", 106, 0, 15, 9, 130
"c:\Users\dunca\Documents\development\apps\sayari\lib\features\files\options.dart", "Dart", 46, 0, 4, 6, 56
"c:\Users\dunca\Documents\development\apps\sayari\lib\features\files\overview.dart", "Dart", 128, 0, 4, 8, 140
"c:\Users\dunca\Documents\development\apps\sayari\lib\features\files\state\data.dart", "Dart", 16, 0, 0, 6, 22
"c:\Users\dunca\Documents\development\apps\sayari\lib\features\files\var\variables.dart", "Dart", 24, 0, 0, 2, 26
"c:\Users\dunca\Documents\development\apps\sayari\lib\features\files\viewer.dart", "Dart", 261, 0, 21, 17, 299
"c:\Users\dunca\Documents\development\apps\sayari\lib\features\finance\_helpers\calculations.dart", "Dart", 14, 0, 0, 5, 19
"c:\Users\dunca\Documents\development\apps\sayari\lib\features\finance\_helpers\helpers.dart", "Dart", 18, 0, 0, 5, 23
"c:\Users\dunca\Documents\development\apps\sayari\lib\features\finance\_vars\variables.dart", "Dart", 28, 0, 0, 3, 31
"c:\Users\dunca\Documents\development\apps\sayari\lib\features\finance\_w\add_entry.dart", "Dart", 76, 0, 9, 4, 89
"c:\Users\dunca\Documents\development\apps\sayari\lib\features\finance\_w\dialog_add_budget.dart", "Dart", 47, 0, 7, 4, 58
"c:\Users\dunca\Documents\development\apps\sayari\lib\features\finance\_w\dialog_add_entry.dart", "Dart", 107, 0, 17, 7, 131
"c:\Users\dunca\Documents\development\apps\sayari\lib\features\finance\_w\entries.dart", "Dart", 31, 0, 0, 6, 37
"c:\Users\dunca\Documents\development\apps\sayari\lib\features\finance\_w\entry.dart", "Dart", 91, 0, 8, 6, 105
"c:\Users\dunca\Documents\development\apps\sayari\lib\features\finance\_w\entry_filter.dart", "Dart", 49, 0, 5, 4, 58
"c:\Users\dunca\Documents\development\apps\sayari\lib\features\finance\_w\footer.dart", "Dart", 70, 0, 8, 4, 82
"c:\Users\dunca\Documents\development\apps\sayari\lib\features\finance\_w\goals.dart", "Dart", 75, 0, 5, 8, 88
"c:\Users\dunca\Documents\development\apps\sayari\lib\features\finance\_w\new_type.dart", "Dart", 62, 0, 6, 7, 75
"c:\Users\dunca\Documents\development\apps\sayari\lib\features\finance\_w\overview.dart", "Dart", 101, 0, 7, 5, 113
"c:\Users\dunca\Documents\development\apps\sayari\lib\features\finance\_w\toggler.dart", "Dart", 23, 0, 0, 5, 28
"c:\Users\dunca\Documents\development\apps\sayari\lib\features\finance\_w_graphs\bar.dart", "Dart", 255, 0, 0, 19, 274
"c:\Users\dunca\Documents\development\apps\sayari\lib\features\finance\_w_graphs\graph_menu.dart", "Dart", 8, 0, 0, 3, 11
"c:\Users\dunca\Documents\development\apps\sayari\lib\features\finance\_w_graphs\indicator.dart", "Dart", 27, 0, 0, 4, 31
"c:\Users\dunca\Documents\development\apps\sayari\lib\features\finance\_w_graphs\line.dart", "Dart", 327, 0, 0, 32, 359
"c:\Users\dunca\Documents\development\apps\sayari\lib\features\finance\_w_graphs\pie.dart", "Dart", 76, 0, 4, 9, 89
"c:\Users\dunca\Documents\development\apps\sayari\lib\features\finance\finance.dart", "Dart", 36, 0, 2, 4, 42
"c:\Users\dunca\Documents\development\apps\sayari\lib\features\finance\graphs_sheet.dart", "Dart", 63, 0, 5, 4, 72
"c:\Users\dunca\Documents\development\apps\sayari\lib\features\flags\_helpers\delete_flag.dart", "Dart", 14, 0, 0, 2, 16
"c:\Users\dunca\Documents\development\apps\sayari\lib\features\flags\_helpers\edit_flag.dart", "Dart", 16, 0, 0, 3, 19
"c:\Users\dunca\Documents\development\apps\sayari\lib\features\flags\_helpers\manage_flag.dart", "Dart", 34, 0, 0, 4, 38
"c:\Users\dunca\Documents\development\apps\sayari\lib\features\flags\flag.dart", "Dart", 162, 0, 11, 11, 184
"c:\Users\dunca\Documents\development\apps\sayari\lib\features\flags\flags_menu.dart", "Dart", 89, 0, 8, 9, 106
"c:\Users\dunca\Documents\development\apps\sayari\lib\features\habits\checked_dates.dart", "Dart", 77, 0, 3, 6, 86
"c:\Users\dunca\Documents\development\apps\sayari\lib\features\habits\habit.dart", "Dart", 37, 0, 4, 5, 46
"c:\Users\dunca\Documents\development\apps\sayari\lib\features\habits\habit_options.dart", "Dart", 51, 0, 3, 5, 59
"c:\Users\dunca\Documents\development\apps\sayari\lib\features\habits\header.dart", "Dart", 51, 0, 8, 6, 65
"c:\Users\dunca\Documents\development\apps\sayari\lib\features\habits\month.dart", "Dart", 154, 0, 13, 9, 176
"c:\Users\dunca\Documents\development\apps\sayari\lib\features\habits\overview.dart", "Dart", 52, 0, 3, 8, 63
"c:\Users\dunca\Documents\development\apps\sayari\lib\features\habits\progress_bar.dart", "Dart", 54, 0, 3, 6, 63
"c:\Users\dunca\Documents\development\apps\sayari\lib\features\habits\week.dart", "Dart", 166, 0, 12, 10, 188
"c:\Users\dunca\Documents\development\apps\sayari\lib\features\habits\year.dart", "Dart", 157, 0, 17, 9, 183
"c:\Users\dunca\Documents\development\apps\sayari\lib\features\links\_helpers\helpers.dart", "Dart", 17, 0, 1, 5, 23
"c:\Users\dunca\Documents\development\apps\sayari\lib\features\links\_w\add_link.dart", "Dart", 44, 0, 3, 4, 51
"c:\Users\dunca\Documents\development\apps\sayari\lib\features\links\_w\checked_dates.dart", "Dart", 81, 0, 3, 8, 92
"c:\Users\dunca\Documents\development\apps\sayari\lib\features\links\_w\header.dart", "Dart", 120, 0, 9, 6, 135
"c:\Users\dunca\Documents\development\apps\sayari\lib\features\links\_w\link_item.dart", "Dart", 240, 0, 22, 11, 273
"c:\Users\dunca\Documents\development\apps\sayari\lib\features\links\_w\links.dart", "Dart", 36, 0, 5, 4, 45
"c:\Users\dunca\Documents\development\apps\sayari\lib\features\links\_w\links_list.dart", "Dart", 50, 0, 4, 8, 62
"c:\Users\dunca\Documents\development\apps\sayari\lib\features\links\_w\overview.dart", "Dart", 60, 0, 3, 5, 68
"c:\Users\dunca\Documents\development\apps\sayari\lib\features\links\_w\username.dart", "Dart", 100, 0, 7, 8, 115
"c:\Users\dunca\Documents\development\apps\sayari\lib\features\links\_w_shared\intro.dart", "Dart", 65, 0, 8, 6, 79
"c:\Users\dunca\Documents\development\apps\sayari\lib\features\links\_w_shared\links_body.dart", "Dart", 107, 0, 11, 8, 126
"c:\Users\dunca\Documents\development\apps\sayari\lib\features\pomodoro\_helpers\helpers.dart", "Dart", 83, 0, 5, 20, 108
"c:\Users\dunca\Documents\development\apps\sayari\lib\features\pomodoro\_helpers\save_settings.dart", "Dart", 26, 0, 1, 5, 32
"c:\Users\dunca\Documents\development\apps\sayari\lib\features\pomodoro\chooser.dart", "Dart", 37, 0, 6, 4, 47
"c:\Users\dunca\Documents\development\apps\sayari\lib\features\pomodoro\counter.dart", "Dart", 91, 0, 9, 6, 106
"c:\Users\dunca\Documents\development\apps\sayari\lib\features\pomodoro\sheet.dart", "Dart", 52, 0, 6, 3, 61
"c:\Users\dunca\Documents\development\apps\sayari\lib\features\pomodoro\state\pomodoro.dart", "Dart", 66, 0, 9, 20, 95
"c:\Users\dunca\Documents\development\apps\sayari\lib\features\pomodoro\type.dart", "Dart", 34, 0, 0, 6, 40
"c:\Users\dunca\Documents\development\apps\sayari\lib\features\pomodoro\var\variables.dart", "Dart", 2, 0, 0, 1, 3
"c:\Users\dunca\Documents\development\apps\sayari\lib\features\pomodoro\w\pause_play_btn.dart", "Dart", 28, 0, 0, 5, 33
"c:\Users\dunca\Documents\development\apps\sayari\lib\features\pomodoro\w\pomo_indicator.dart", "Dart", 34, 0, 0, 5, 39
"c:\Users\dunca\Documents\development\apps\sayari\lib\features\pomodoro\w_settings\alarm_chooser.dart", "Dart", 24, 0, 2, 4, 30
"c:\Users\dunca\Documents\development\apps\sayari\lib\features\pomodoro\w_settings\setting.dart", "Dart", 73, 0, 11, 5, 89
"c:\Users\dunca\Documents\development\apps\sayari\lib\features\pomodoro\w_settings\settings_dialog.dart", "Dart", 68, 0, 13, 5, 86
"c:\Users\dunca\Documents\development\apps\sayari\lib\features\reminders\_helpers\helper.dart", "Dart", 22, 0, 0, 5, 27
"c:\Users\dunca\Documents\development\apps\sayari\lib\features\reminders\_helpers\register_reminder.dart", "Dart", 60, 0, 13, 7, 80
"c:\Users\dunca\Documents\development\apps\sayari\lib\features\reminders\_helpers\reminders.dart", "Dart", 37, 0, 0, 6, 43
"c:\Users\dunca\Documents\development\apps\sayari\lib\features\reminders\reminder.dart", "Dart", 86, 0, 3, 8, 97
"c:\Users\dunca\Documents\development\apps\sayari\lib\features\reminders\reminder_menu.dart", "Dart", 151, 0, 15, 11, 177
"c:\Users\dunca\Documents\development\apps\sayari\lib\features\saved\_helpers\helpers.dart", "Dart", 0, 0, 0, 2, 2
"c:\Users\dunca\Documents\development\apps\sayari\lib\features\saved\saved_sheet.dart", "Dart", 31, 0, 5, 3, 39
"c:\Users\dunca\Documents\development\apps\sayari\lib\features\saved\w\misc.dart", "Dart", 0, 0, 0, 2, 2
"c:\Users\dunca\Documents\development\apps\sayari\lib\features\search\_helpers\helpers.dart", "Dart", 0, 0, 0, 2, 2
"c:\Users\dunca\Documents\development\apps\sayari\lib\features\search\_helpers\search.dart", "Dart", 1, 0, 0, 1, 2
"c:\Users\dunca\Documents\development\apps\sayari\lib\features\search\search_bar.dart", "Dart", 53, 0, 0, 5, 58
"c:\Users\dunca\Documents\development\apps\sayari\lib\features\search\search_btn.dart", "Dart", 22, 0, 0, 5, 27
"c:\Users\dunca\Documents\development\apps\sayari\lib\features\search\search_sheet.dart", "Dart", 22, 0, 5, 4, 31
"c:\Users\dunca\Documents\development\apps\sayari\lib\features\settings\edit_details.dart", "Dart", 69, 0, 15, 4, 88
"c:\Users\dunca\Documents\development\apps\sayari\lib\features\settings\settings_sheet.dart", "Dart", 42, 0, 7, 3, 52
"c:\Users\dunca\Documents\development\apps\sayari\lib\features\settings\w\account_details.dart", "Dart", 39, 0, 16, 4, 59
"c:\Users\dunca\Documents\development\apps\sayari\lib\features\settings\w\account_support.dart", "Dart", 39, 0, 6, 4, 49
"c:\Users\dunca\Documents\development\apps\sayari\lib\features\settings\w\reset_password.dart", "Dart", 43, 0, 5, 4, 52
"c:\Users\dunca\Documents\development\apps\sayari\lib\features\settings\w\theme_settings.dart", "Dart", 36, 0, 4, 4, 44
"c:\Users\dunca\Documents\development\apps\sayari\lib\features\settings\w\title.dart", "Dart", 20, 0, 0, 5, 25
"c:\Users\dunca\Documents\development\apps\sayari\lib\features\settings\w\usr_name.dart", "Dart", 31, 0, 0, 7, 38
"c:\Users\dunca\Documents\development\apps\sayari\lib\features\share\_helpers\helpers.dart", "Dart", 28, 0, 0, 4, 32
"c:\Users\dunca\Documents\development\apps\sayari\lib\features\share\shared.dart", "Dart", 129, 0, 9, 5, 143
"c:\Users\dunca\Documents\development\apps\sayari\lib\features\share\shared_note.dart", "Dart", 114, 0, 7, 10, 131
"c:\Users\dunca\Documents\development\apps\sayari\lib\features\share\shared_space.dart", "Dart", 91, 0, 2, 10, 103
"c:\Users\dunca\Documents\development\apps\sayari\lib\features\share\state\share.dart", "Dart", 25, 0, 2, 8, 35
"c:\Users\dunca\Documents\development\apps\sayari\lib\features\share\test_screen.dart", "Dart", 32, 0, 0, 5, 37
"c:\Users\dunca\Documents\development\apps\sayari\lib\features\share\w\header.dart", "Dart", 51, 0, 3, 5, 59
"c:\Users\dunca\Documents\development\apps\sayari\lib\features\share\w\preview.dart", "Dart", 35, 0, 0, 5, 40
"c:\Users\dunca\Documents\development\apps\sayari\lib\features\share\w\share_link.dart", "Dart", 45, 0, 0, 5, 50
"c:\Users\dunca\Documents\development\apps\sayari\lib\features\share\w\shared_info.dart", "Dart", 53, 0, 0, 5, 58
"c:\Users\dunca\Documents\development\apps\sayari\lib\features\tags\_helpers\add_new_tag.dart", "Dart", 23, 0, 4, 2, 29
"c:\Users\dunca\Documents\development\apps\sayari\lib\features\tags\_helpers\delete_tag.dart", "Dart", 15, 0, 0, 2, 17
"c:\Users\dunca\Documents\development\apps\sayari\lib\features\tags\list_of_tags.dart", "Dart", 72, 0, 2, 10, 84
"c:\Users\dunca\Documents\development\apps\sayari\lib\features\tags\manager.dart", "Dart", 116, 0, 10, 9, 135
"c:\Users\dunca\Documents\development\apps\sayari\lib\features\tags\menu.dart", "Dart", 15, 0, 3, 3, 21
"c:\Users\dunca\Documents\development\apps\sayari\lib\features\tags\new_tag.dart", "Dart", 83, 0, 5, 7, 95
"c:\Users\dunca\Documents\development\apps\sayari\lib\features\tags\selector.dart", "Dart", 31, 0, 0, 4, 35
"c:\Users\dunca\Documents\development\apps\sayari\lib\features\tags\tag.dart", "Dart", 90, 0, 3, 8, 101
"c:\Users\dunca\Documents\development\apps\sayari\lib\features\tags\var\tag_model.dart", "Dart", 13, 0, 0, 4, 17
"c:\Users\dunca\Documents\development\apps\sayari\lib\features\tasks\_helpers\helper.dart", "Dart", 9, 0, 1, 4, 14
"c:\Users\dunca\Documents\development\apps\sayari\lib\features\tasks\_helpers\ontap.dart", "Dart", 16, 0, 1, 4, 21
"c:\Users\dunca\Documents\development\apps\sayari\lib\features\tasks\_helpers\quicktask_helpers.dart", "Dart", 11, 0, 1, 4, 16
"c:\Users\dunca\Documents\development\apps\sayari\lib\features\tasks\new_item.dart", "Dart", 135, 0, 8, 10, 153
"c:\Users\dunca\Documents\development\apps\sayari\lib\features\tasks\quicktasks\qt_item.dart", "Dart", 85, 0, 5, 6, 96
"c:\Users\dunca\Documents\development\apps\sayari\lib\features\tasks\quicktasks\qt_menu.dart", "Dart", 23, 0, 0, 3, 26
"c:\Users\dunca\Documents\development\apps\sayari\lib\features\tasks\quicktasks\quick_tasks.dart", "Dart", 62, 0, 5, 5, 72
"c:\Users\dunca\Documents\development\apps\sayari\lib\features\tasks\quicktasks\quick_tasks_list.dart", "Dart", 40, 0, 13, 5, 58
"c:\Users\dunca\Documents\development\apps\sayari\lib\features\tasks\subitem.dart", "Dart", 123, 0, 10, 8, 141
"c:\Users\dunca\Documents\development\apps\sayari\lib\features\tasks\subitems.dart", "Dart", 54, 0, 0, 7, 61
"c:\Users\dunca\Documents\development\apps\sayari\lib\features\tasks\task.dart", "Dart", 29, 0, 4, 4, 37
"c:\Users\dunca\Documents\development\apps\sayari\lib\features\tasks\task_options.dart", "Dart", 60, 0, 7, 5, 72
"c:\Users\dunca\Documents\development\apps\sayari\lib\features\tasks\w_items\delete_item_menu.dart", "Dart", 25, 0, 0, 4, 29
"c:\Users\dunca\Documents\development\apps\sayari\lib\features\tasks\w_items\edit_subitem.dart", "Dart", 111, 0, 27, 5, 143
"c:\Users\dunca\Documents\development\apps\sayari\lib\features\tasks\w_items\flag_list.dart", "Dart", 47, 0, 2, 7, 56
"c:\Users\dunca\Documents\development\apps\sayari\lib\features\tasks\w_items\item_flag.dart", "Dart", 56, 0, 3, 6, 65
"c:\Users\dunca\Documents\development\apps\sayari\lib\features\tasks\w_items\progress.dart", "Dart", 45, 0, 4, 5, 54
"c:\Users\dunca\Documents\development\apps\sayari\lib\features\timeline\timeline.dart", "Dart", 25, 0, 2, 4, 31
"c:\Users\dunca\Documents\development\apps\sayari\lib\features\tts\_helpers\tts_helpers.dart", "Dart", 17, 0, 0, 3, 20
"c:\Users\dunca\Documents\development\apps\sayari\lib\features\tts\_helpers\tts_service.dart", "Dart", 44, 0, 0, 10, 54
"c:\Users\dunca\Documents\development\apps\sayari\lib\features\tts\_state\tts_provider.dart", "Dart", 23, 0, 6, 9, 38
"c:\Users\dunca\Documents\development\apps\sayari\lib\features\tts\_w\tts_button.dart", "Dart", 27, 0, 0, 5, 32
"c:\Users\dunca\Documents\development\apps\sayari\lib\features\tts\_w\tts_controls.dart", "Dart", 41, 0, 6, 6, 53
"c:\Users\dunca\Documents\development\apps\sayari\lib\features\user\_helpers\actions.dart", "Dart", 113, 0, 15, 15, 143
"c:\Users\dunca\Documents\development\apps\sayari\lib\features\user\_helpers\dp.dart", "Dart", 49, 0, 0, 4, 53
"c:\Users\dunca\Documents\development\apps\sayari\lib\features\user\_helpers\edit_user_details.dart", "Dart", 55, 0, 0, 9, 64
"c:\Users\dunca\Documents\development\apps\sayari\lib\features\user\_helpers\helpers.dart", "Dart", 16, 0, 3, 4, 23
"c:\Users\dunca\Documents\development\apps\sayari\lib\features\user\_helpers\saved.dart", "Dart", 39, 0, 0, 4, 43
"c:\Users\dunca\Documents\development\apps\sayari\lib\features\user\dp.dart", "Dart", 76, 0, 2, 12, 90
"c:\Users\dunca\Documents\development\apps\sayari\lib\features\user\dp_menu.dart", "Dart", 61, 0, 6, 4, 71
"c:\Users\dunca\Documents\development\apps\sayari\lib\firebase_options.dart", "Dart", 63, 0, 12, 5, 80
"c:\Users\dunca\Documents\development\apps\sayari\lib\main.dart", "Dart", 53, 0, 0, 8, 61
"Total", "-", 25366, 8, 2003, 2873, 30250