"filename", "language", "Dart", "Markdown", "comment", "blank", "total"
"c:\Users\dunca\Documents\development\apps\sayari\lib\__app\app_notes.md", "Markdown", 0, 8, 0, 7, 15
"c:\Users\dunca\Documents\development\apps\sayari\lib\__app\todo.md", "Markdown", 0, 5, 0, 4, 9
"c:\Users\dunca\Documents\development\apps\sayari\lib\__routing\routes.dart", "Dart", 47, 0, 5, 4, 56
"c:\Users\dunca\Documents\development\apps\sayari\lib\__styling\breakpoints.dart", "Dart", 9, 0, 0, 3, 12
"c:\Users\dunca\Documents\development\apps\sayari\lib\__styling\helpers.dart", "Dart", 68, 0, 3, 12, 83
"c:\Users\dunca\Documents\development\apps\sayari\lib\__styling\spacing.dart", "Dart", 73, 0, 6, 12, 91
"c:\Users\dunca\Documents\development\apps\sayari\lib\__styling\styler.dart", "Dart", 165, 0, 6, 42, 213
"c:\Users\dunca\Documents\development\apps\sayari\lib\__styling\theme.dart", "Dart", 77, 0, 0, 3, 80
"c:\Users\dunca\Documents\development\apps\sayari\lib\__styling\variables.dart", "Dart", 73, 0, 6, 14, 93
"c:\Users\dunca\Documents\development\apps\sayari\lib\_helpers\_common\background_ops.dart", "Dart", 10, 0, 0, 3, 13
"c:\Users\dunca\Documents\development\apps\sayari\lib\_helpers\_common\global.dart", "Dart", 66, 0, 1, 14, 81
"c:\Users\dunca\Documents\development\apps\sayari\lib\_helpers\_common\helpers.dart", "Dart", 4, 0, 0, 2, 6
"c:\Users\dunca\Documents\development\apps\sayari\lib\_helpers\_common\internet_connection.dart", "Dart", 4, 0, 27, 9, 40
"c:\Users\dunca\Documents\development\apps\sayari\lib\_helpers\_common\keyboard.dart", "Dart", 17, 0, 0, 5, 22
"c:\Users\dunca\Documents\development\apps\sayari\lib\_helpers\_common\loaders.dart", "Dart", 2, 0, 0, 2, 4
"c:\Users\dunca\Documents\development\apps\sayari\lib\_helpers\_common\misc.dart", "Dart", 20, 0, 0, 5, 25
"c:\Users\dunca\Documents\development\apps\sayari\lib\_helpers\_common\navigation.dart", "Dart", 61, 0, 0, 15, 76
"c:\Users\dunca\Documents\development\apps\sayari\lib\_helpers\_common\scroll.dart", "Dart", 0, 0, 0, 2, 2
"c:\Users\dunca\Documents\development\apps\sayari\lib\_helpers\_common\ui.dart", "Dart", 4, 0, 0, 3, 7
"c:\Users\dunca\Documents\development\apps\sayari\lib\_helpers\_common\url_launcher.dart", "Dart", 19, 0, 2, 3, 24
"c:\Users\dunca\Documents\development\apps\sayari\lib\_helpers\date_time\checks_date.dart", "Dart", 11, 0, 0, 4, 15
"c:\Users\dunca\Documents\development\apps\sayari\lib\_helpers\date_time\date_info.dart", "Dart", 82, 0, 0, 18, 100
"c:\Users\dunca\Documents\development\apps\sayari\lib\_helpers\date_time\get_week_no.dart", "Dart", 16, 0, 2, 3, 21
"c:\Users\dunca\Documents\development\apps\sayari\lib\_helpers\date_time\jump_to_date.dart", "Dart", 44, 0, 0, 6, 50
"c:\Users\dunca\Documents\development\apps\sayari\lib\_helpers\date_time\misc.dart", "Dart", 121, 0, 1, 21, 143
"c:\Users\dunca\Documents\development\apps\sayari\lib\_helpers\date_time\months.dart", "Dart", 23, 0, 0, 6, 29
"c:\Users\dunca\Documents\development\apps\sayari\lib\_helpers\date_time\weeks.dart", "Dart", 81, 0, 0, 3, 84
"c:\Users\dunca\Documents\development\apps\sayari\lib\_helpers\errors\error_handler.dart", "Dart", 21, 0, 3, 6, 30
"c:\Users\dunca\Documents\development\apps\sayari\lib\_helpers\forms\form_validation_helper.dart", "Dart", 26, 0, 0, 7, 33
"c:\Users\dunca\Documents\development\apps\sayari\lib\_helpers\forms\regex_checks.dart", "Dart", 13, 0, 0, 6, 19
"c:\Users\dunca\Documents\development\apps\sayari\lib\_helpers\pending\pending_actions.dart", "Dart", 43, 0, 1, 6, 50
"c:\Users\dunca\Documents\development\apps\sayari\lib\_helpers\pending\retry_pending_actions.dart", "Dart", 35, 0, 13, 3, 51
"c:\Users\dunca\Documents\development\apps\sayari\lib\_models\data.dart", "Dart", 28, 0, 0, 6, 34
"c:\Users\dunca\Documents\development\apps\sayari\lib\_models\features.dart", "Dart", 16, 0, 0, 3, 19
"c:\Users\dunca\Documents\development\apps\sayari\lib\_models\files.dart", "Dart", 11, 0, 0, 3, 14
"c:\Users\dunca\Documents\development\apps\sayari\lib\_models\item.dart", "Dart", 76, 0, 3, 11, 90
"c:\Users\dunca\Documents\development\apps\sayari\lib\_providers\common\activity.dart", "Dart", 0, 0, 0, 2, 2
"c:\Users\dunca\Documents\development\apps\sayari\lib\_providers\common\ble.dart", "Dart", 18, 0, 3, 8, 29
"c:\Users\dunca\Documents\development\apps\sayari\lib\_providers\common\data.dart", "Dart", 16, 0, 0, 6, 22
"c:\Users\dunca\Documents\development\apps\sayari\lib\_providers\common\datetime.dart", "Dart", 55, 0, 1, 14, 70
"c:\Users\dunca\Documents\development\apps\sayari\lib\_providers\common\global.dart", "Dart", 22, 0, 4, 9, 35
"c:\Users\dunca\Documents\development\apps\sayari\lib\_providers\common\input.dart", "Dart", 120, 0, 6, 27, 153
"c:\Users\dunca\Documents\development\apps\sayari\lib\_providers\common\misc.dart", "Dart", 55, 0, 2, 16, 73
"c:\Users\dunca\Documents\development\apps\sayari\lib\_providers\common\pomodoro.dart", "Dart", 66, 0, 9, 20, 95
"c:\Users\dunca\Documents\development\apps\sayari\lib\_providers\common\quill.dart", "Dart", 30, 0, 4, 12, 46
"c:\Users\dunca\Documents\development\apps\sayari\lib\_providers\common\selection.dart", "Dart", 23, 0, 1, 6, 30
"c:\Users\dunca\Documents\development\apps\sayari\lib\_providers\common\theme.dart", "Dart", 22, 0, 0, 5, 27
"c:\Users\dunca\Documents\development\apps\sayari\lib\_providers\common\views.dart", "Dart", 59, 0, 7, 22, 88
"c:\Users\dunca\Documents\development\apps\sayari\lib\_providers\providers.dart", "Dart", 67, 0, 9, 8, 84
"c:\Users\dunca\Documents\development\apps\sayari\lib\_services\activity\activity_helper.dart", "Dart", 24, 0, 0, 5, 29
"c:\Users\dunca\Documents\development\apps\sayari\lib\_services\activity\listen_for_updates.dart", "Dart", 88, 0, 6, 14, 108
"c:\Users\dunca\Documents\development\apps\sayari\lib\_services\activity\save_activity.dart", "Dart", 9, 0, 30, 8, 47
"c:\Users\dunca\Documents\development\apps\sayari\lib\_services\activity\variables.dart", "Dart", 4, 0, 0, 3, 7
"c:\Users\dunca\Documents\development\apps\sayari\lib\_services\firebase\_helpers\handle_errors.dart", "Dart", 21, 0, 4, 4, 29
"c:\Users\dunca\Documents\development\apps\sayari\lib\_services\firebase\_helpers\helpers.dart", "Dart", 45, 0, 0, 8, 53
"c:\Users\dunca\Documents\development\apps\sayari\lib\_services\firebase\database.dart", "Dart", 56, 0, 0, 16, 72
"c:\Users\dunca\Documents\development\apps\sayari\lib\_services\firebase\get_space_data.dart", "Dart", 135, 0, 0, 16, 151
"c:\Users\dunca\Documents\development\apps\sayari\lib\_services\firebase\get_user_data.dart", "Dart", 48, 0, 4, 5, 57
"c:\Users\dunca\Documents\development\apps\sayari\lib\_services\firebase\storage.dart", "Dart", 101, 0, 12, 15, 128
"c:\Users\dunca\Documents\development\apps\sayari\lib\_services\firebase\sync_from_cloud.dart", "Dart", 132, 0, 27, 16, 175
"c:\Users\dunca\Documents\development\apps\sayari\lib\_services\firebase\sync_to_cloud.dart", "Dart", 110, 0, 53, 11, 174
"c:\Users\dunca\Documents\development\apps\sayari\lib\_services\hive\get_data.dart", "Dart", 9, 0, 0, 3, 12
"c:\Users\dunca\Documents\development\apps\sayari\lib\_services\hive\load_boxes.dart", "Dart", 43, 0, 2, 7, 52
"c:\Users\dunca\Documents\development\apps\sayari\lib\_services\hive\local_storage_service.dart", "Dart", 12, 0, 1, 2, 15
"c:\Users\dunca\Documents\development\apps\sayari\lib\_services\notifications\act_on_notification.dart", "Dart", 4, 0, 0, 2, 6
"c:\Users\dunca\Documents\development\apps\sayari\lib\_services\notifications\create_notification.dart", "Dart", 69, 0, 1, 7, 77
"c:\Users\dunca\Documents\development\apps\sayari\lib\_services\notifications\init_notifications.dart", "Dart", 29, 0, 0, 4, 33
"c:\Users\dunca\Documents\development\apps\sayari\lib\_services\notifications\listen_for_notification.dart", "Dart", 7, 0, 0, 3, 10
"c:\Users\dunca\Documents\development\apps\sayari\lib\_services\notifications\notifications.dart", "Dart", 9, 0, 0, 3, 12
"c:\Users\dunca\Documents\development\apps\sayari\lib\_variables\colors.dart", "Dart", 28, 0, 0, 3, 31
"c:\Users\dunca\Documents\development\apps\sayari\lib\_variables\constants.dart", "Dart", 17, 0, 1, 8, 26
"c:\Users\dunca\Documents\development\apps\sayari\lib\_variables\date_time.dart", "Dart", 108, 0, 4, 9, 121
"c:\Users\dunca\Documents\development\apps\sayari\lib\_variables\emojis.dart", "Dart", 15, 0, 0, 1, 16
"c:\Users\dunca\Documents\development\apps\sayari\lib\_variables\features.dart", "Dart", 63, 0, 0, 6, 69
"c:\Users\dunca\Documents\development\apps\sayari\lib\_variables\global.dart", "Dart", 1, 0, 0, 1, 2
"c:\Users\dunca\Documents\development\apps\sayari\lib\_variables\intro_features.dart", "Dart", 7, 0, 3, 2, 12
"c:\Users\dunca\Documents\development\apps\sayari\lib\_variables\navigation.dart", "Dart", 7, 0, 0, 5, 12
"c:\Users\dunca\Documents\development\apps\sayari\lib\_variables\ui.dart", "Dart", 3, 0, 0, 2, 5
"c:\Users\dunca\Documents\development\apps\sayari\lib\_widgets\buttons\buttons.dart", "Dart", 156, 0, 0, 7, 163
"c:\Users\dunca\Documents\development\apps\sayari\lib\_widgets\buttons\close_button.dart", "Dart", 30, 0, 3, 6, 39
"c:\Users\dunca\Documents\development\apps\sayari\lib\_widgets\buttons\color_button.dart", "Dart", 40, 0, 0, 6, 46
"c:\Users\dunca\Documents\development\apps\sayari\lib\_widgets\dialogs\app_dialog.dart", "Dart", 80, 0, 9, 5, 94
"c:\Users\dunca\Documents\development\apps\sayari\lib\_widgets\dialogs\confirmation_dialog.dart", "Dart", 34, 0, 0, 4, 38
"c:\Users\dunca\Documents\development\apps\sayari\lib\_widgets\dialogs\dialog_about_app.dart", "Dart", 0, 0, 0, 2, 2
"c:\Users\dunca\Documents\development\apps\sayari\lib\_widgets\dialogs\dialog_buttons.dart", "Dart", 24, 0, 0, 5, 29
"c:\Users\dunca\Documents\development\apps\sayari\lib\_widgets\dialogs\dialog_option_button.dart", "Dart", 20, 0, 0, 5, 25
"c:\Users\dunca\Documents\development\apps\sayari\lib\_widgets\dialogs\dialog_select_date.dart", "Dart", 43, 0, 4, 5, 52
"c:\Users\dunca\Documents\development\apps\sayari\lib\_widgets\dialogs\dialog_select_groups.dart", "Dart", 67, 0, 0, 6, 73
"c:\Users\dunca\Documents\development\apps\sayari\lib\_widgets\layout\column_layout.dart", "Dart", 50, 0, 0, 5, 55
"c:\Users\dunca\Documents\development\apps\sayari\lib\_widgets\layout\grid_layout.dart", "Dart", 44, 0, 0, 6, 50
"c:\Users\dunca\Documents\development\apps\sayari\lib\_widgets\layout\layout_button.dart", "Dart", 56, 0, 2, 5, 63
"c:\Users\dunca\Documents\development\apps\sayari\lib\_widgets\layout\list_layout.dart", "Dart", 43, 0, 0, 5, 48
"c:\Users\dunca\Documents\development\apps\sayari\lib\_widgets\layout\list_of_items.dart", "Dart", 46, 0, 4, 6, 56
"c:\Users\dunca\Documents\development\apps\sayari\lib\_widgets\layout\masonry\foundation\extensions.dart", "Dart", 11, 0, 1, 2, 14
"c:\Users\dunca\Documents\development\apps\sayari\lib\_widgets\layout\masonry\rendering\sliver_masonry_grid.dart", "Dart", 441, 0, 132, 79, 652
"c:\Users\dunca\Documents\development\apps\sayari\lib\_widgets\layout\masonry\rendering\sliver_simple_grid_delegate.dart", "Dart", 25, 0, 34, 9, 68
"c:\Users\dunca\Documents\development\apps\sayari\lib\_widgets\layout\masonry\widgets\masonry_grid_view.dart", "Dart", 82, 0, 13, 9, 104
"c:\Users\dunca\Documents\development\apps\sayari\lib\_widgets\layout\masonry\widgets\sliver_masonry_grid.dart", "Dart", 32, 0, 4, 7, 43
"c:\Users\dunca\Documents\development\apps\sayari\lib\_widgets\layout\orderables\background.dart", "Dart", 20, 0, 0, 4, 24
"c:\Users\dunca\Documents\development\apps\sayari\lib\_widgets\layout\orderables\reorderableitemsview.dart", "Dart", 0, 0, 600, 78, 678
"c:\Users\dunca\Documents\development\apps\sayari\lib\_widgets\layout\reords\reorderable_grid.dart", "Dart", 736, 0, 302, 144, 1182
"c:\Users\dunca\Documents\development\apps\sayari\lib\_widgets\layout\reords\reorderable_grid_view.dart", "Dart", 130, 0, 18, 23, 171
"c:\Users\dunca\Documents\development\apps\sayari\lib\_widgets\layout\reords\typedefs.dart", "Dart", 1, 0, 0, 1, 2
"c:\Users\dunca\Documents\development\apps\sayari\lib\_widgets\menu\confirmation.dart", "Dart", 27, 0, 3, 3, 33
"c:\Users\dunca\Documents\development\apps\sayari\lib\_widgets\menu\custom_menu.dart", "Dart", 431, 0, 44, 63, 538
"c:\Users\dunca\Documents\development\apps\sayari\lib\_widgets\menu\menu.dart", "Dart", 16, 0, 0, 4, 20
"c:\Users\dunca\Documents\development\apps\sayari\lib\_widgets\menu\menu_item.dart", "Dart", 100, 0, 1, 7, 108
"c:\Users\dunca\Documents\development\apps\sayari\lib\_widgets\others\checkbox.dart", "Dart", 62, 0, 0, 7, 69
"c:\Users\dunca\Documents\development\apps\sayari\lib\_widgets\others\color_menu.dart", "Dart", 63, 0, 2, 9, 74
"c:\Users\dunca\Documents\development\apps\sayari\lib\_widgets\others\empty_box.dart", "Dart", 43, 0, 10, 5, 58
"c:\Users\dunca\Documents\development\apps\sayari\lib\_widgets\others\forms\auth_input.dart", "Dart", 89, 0, 0, 8, 97
"c:\Users\dunca\Documents\development\apps\sayari\lib\_widgets\others\forms\input.dart", "Dart", 128, 0, 0, 7, 135
"c:\Users\dunca\Documents\development\apps\sayari\lib\_widgets\others\forms\numeric.dart", "Dart", 58, 0, 0, 5, 63
"c:\Users\dunca\Documents\development\apps\sayari\lib\_widgets\others\icons.dart", "Dart", 35, 0, 0, 5, 40
"c:\Users\dunca\Documents\development\apps\sayari\lib\_widgets\others\images.dart", "Dart", 32, 0, 0, 4, 36
"c:\Users\dunca\Documents\development\apps\sayari\lib\_widgets\others\loader.dart", "Dart", 23, 0, 0, 5, 28
"c:\Users\dunca\Documents\development\apps\sayari\lib\_widgets\others\others\about_app.dart", "Dart", 44, 0, 12, 4, 60
"c:\Users\dunca\Documents\development\apps\sayari\lib\_widgets\others\others\confetti.dart", "Dart", 0, 0, 21, 7, 28
"c:\Users\dunca\Documents\development\apps\sayari\lib\_widgets\others\others\dev_tools.dart", "Dart", 41, 0, 5, 4, 50
"c:\Users\dunca\Documents\development\apps\sayari\lib\_widgets\others\others\divider.dart", "Dart", 17, 0, 0, 5, 22
"c:\Users\dunca\Documents\development\apps\sayari\lib\_widgets\others\others\dry_intrinsic_size.dart", "Dart", 36, 0, 7, 7, 50
"c:\Users\dunca\Documents\development\apps\sayari\lib\_widgets\others\others\keyboard_listener.dart", "Dart", 45, 0, 0, 9, 54
"c:\Users\dunca\Documents\development\apps\sayari\lib\_widgets\others\others\list_tile.dart", "Dart", 28, 0, 4, 5, 37
"c:\Users\dunca\Documents\development\apps\sayari\lib\_widgets\others\others\other_widgets.dart", "Dart", 6, 0, 0, 3, 9
"c:\Users\dunca\Documents\development\apps\sayari\lib\_widgets\others\others\scroll.dart", "Dart", 93, 0, 11, 24, 128
"c:\Users\dunca\Documents\development\apps\sayari\lib\_widgets\others\others\snap_scroll_physics.dart", "Dart", 75, 0, 8, 18, 101
"c:\Users\dunca\Documents\development\apps\sayari\lib\_widgets\others\others\swipe_detector.dart", "Dart", 72, 0, 1, 14, 87
"c:\Users\dunca\Documents\development\apps\sayari\lib\_widgets\others\others\sync_indicator.dart", "Dart", 49, 0, 0, 10, 59
"c:\Users\dunca\Documents\development\apps\sayari\lib\_widgets\others\sfcalendar.dart", "Dart", 140, 0, 12, 7, 159
"c:\Users\dunca\Documents\development\apps\sayari\lib\_widgets\others\snackbar.dart", "Dart", 41, 0, 10, 3, 54
"c:\Users\dunca\Documents\development\apps\sayari\lib\_widgets\others\svg.dart", "Dart", 32, 0, 0, 5, 37
"c:\Users\dunca\Documents\development\apps\sayari\lib\_widgets\others\text.dart", "Dart", 70, 0, 0, 8, 78
"c:\Users\dunca\Documents\development\apps\sayari\lib\_widgets\others\theme.dart", "Dart", 93, 0, 3, 8, 104
"c:\Users\dunca\Documents\development\apps\sayari\lib\_widgets\others\toast.dart", "Dart", 60, 0, 6, 5, 71
"c:\Users\dunca\Documents\development\apps\sayari\lib\_widgets\others\tooltip.dart", "Dart", 31, 0, 0, 5, 36
"c:\Users\dunca\Documents\development\apps\sayari\lib\_widgets\sheets\bottom_sheet.dart", "Dart", 135, 0, 19, 6, 160
"c:\Users\dunca\Documents\development\apps\sayari\lib\features\_calendar\_helpers\actions.dart", "Dart", 39, 0, 2, 6, 47
"c:\Users\dunca\Documents\development\apps\sayari\lib\features\_calendar\_helpers\go_to_today.dart", "Dart", 21, 0, 1, 3, 25
"c:\Users\dunca\Documents\development\apps\sayari\lib\features\_calendar\_helpers\helpers.dart", "Dart", 38, 0, 0, 6, 44
"c:\Users\dunca\Documents\development\apps\sayari\lib\features\_calendar\_helpers\sort.dart", "Dart", 12, 0, 1, 3, 16
"c:\Users\dunca\Documents\development\apps\sayari\lib\features\_calendar\_helpers\swipe.dart", "Dart", 30, 0, 0, 7, 37
"c:\Users\dunca\Documents\development\apps\sayari\lib\features\_calendar\_vars\variables.dart", "Dart", 23, 0, 0, 1, 24
"c:\Users\dunca\Documents\development\apps\sayari\lib\features\_calendar\_w\calendar_options.dart", "Dart", 77, 0, 8, 5, 90
"c:\Users\dunca\Documents\development\apps\sayari\lib\features\_calendar\_w\daily_box.dart", "Dart", 96, 0, 8, 5, 109
"c:\Users\dunca\Documents\development\apps\sayari\lib\features\_calendar\_w\monthly_box.dart", "Dart", 33, 0, 0, 5, 38
"c:\Users\dunca\Documents\development\apps\sayari\lib\features\_calendar\_w\sessions_list_menu.dart", "Dart", 61, 0, 8, 5, 74
"c:\Users\dunca\Documents\development\apps\sayari\lib\features\_calendar\_w\weekly_box copy.dart", "Dart", 70, 0, 3, 6, 79
"c:\Users\dunca\Documents\development\apps\sayari\lib\features\_calendar\_w\weekly_box.dart", "Dart", 70, 0, 3, 6, 79
"c:\Users\dunca\Documents\development\apps\sayari\lib\features\_calendar\daily\daily.dart", "Dart", 112, 0, 7, 7, 126
"c:\Users\dunca\Documents\development\apps\sayari\lib\features\_calendar\daily\daily_time_divider.dart", "Dart", 12, 0, 0, 4, 16
"c:\Users\dunca\Documents\development\apps\sayari\lib\features\_calendar\info_header.dart", "Dart", 83, 0, 10, 5, 98
"c:\Users\dunca\Documents\development\apps\sayari\lib\features\_calendar\monthly\day_label.dart", "Dart", 30, 0, 0, 6, 36
"c:\Users\dunca\Documents\development\apps\sayari\lib\features\_calendar\monthly\list_of_sessions.dart", "Dart", 24, 0, 0, 6, 30
"c:\Users\dunca\Documents\development\apps\sayari\lib\features\_calendar\monthly\monthly.dart", "Dart", 107, 0, 3, 7, 117
"c:\Users\dunca\Documents\development\apps\sayari\lib\features\_calendar\monthly\weekday_labels.dart", "Dart", 44, 0, 0, 5, 49
"c:\Users\dunca\Documents\development\apps\sayari\lib\features\_calendar\new_session\_w\about.dart", "Dart", 26, 0, 4, 4, 34
"c:\Users\dunca\Documents\development\apps\sayari\lib\features\_calendar\new_session\_w\color.dart", "Dart", 20, 0, 0, 4, 24
"c:\Users\dunca\Documents\development\apps\sayari\lib\features\_calendar\new_session\_w\date.dart", "Dart", 93, 0, 13, 4, 110
"c:\Users\dunca\Documents\development\apps\sayari\lib\features\_calendar\new_session\_w\date_item.dart", "Dart", 32, 0, 1, 5, 38
"c:\Users\dunca\Documents\development\apps\sayari\lib\features\_calendar\new_session\_w\date_range_dialog.dart", "Dart", 128, 0, 12, 3, 143
"c:\Users\dunca\Documents\development\apps\sayari\lib\features\_calendar\new_session\_w\files.dart", "Dart", 46, 0, 7, 4, 57
"c:\Users\dunca\Documents\development\apps\sayari\lib\features\_calendar\new_session\_w\lead.dart", "Dart", 26, 0, 4, 4, 34
"c:\Users\dunca\Documents\development\apps\sayari\lib\features\_calendar\new_session\_w\reminder_item.dart", "Dart", 86, 0, 5, 7, 98
"c:\Users\dunca\Documents\development\apps\sayari\lib\features\_calendar\new_session\_w\reminders.dart", "Dart", 67, 0, 6, 5, 78
"c:\Users\dunca\Documents\development\apps\sayari\lib\features\_calendar\new_session\_w\time.dart", "Dart", 86, 0, 9, 5, 100
"c:\Users\dunca\Documents\development\apps\sayari\lib\features\_calendar\new_session\_w\type.dart", "Dart", 23, 0, 0, 4, 27
"c:\Users\dunca\Documents\development\apps\sayari\lib\features\_calendar\new_session\_w\venue.dart", "Dart", 26, 0, 4, 4, 34
"c:\Users\dunca\Documents\development\apps\sayari\lib\features\_calendar\new_session\session_dialog.dart", "Dart", 94, 0, 10, 4, 108
"c:\Users\dunca\Documents\development\apps\sayari\lib\features\_calendar\overview\dialog_session_overview.dart", "Dart", 80, 0, 12, 4, 96
"c:\Users\dunca\Documents\development\apps\sayari\lib\features\_calendar\overview\session_info_tile.dart", "Dart", 24, 0, 0, 5, 29
"c:\Users\dunca\Documents\development\apps\sayari\lib\features\_calendar\overview\session_options.dart", "Dart", 65, 0, 5, 5, 75
"c:\Users\dunca\Documents\development\apps\sayari\lib\features\_calendar\overview\session_reminders.dart", "Dart", 37, 0, 3, 6, 46
"c:\Users\dunca\Documents\development\apps\sayari\lib\features\_calendar\overview\session_time.dart", "Dart", 28, 0, 3, 6, 37
"c:\Users\dunca\Documents\development\apps\sayari\lib\features\_calendar\overview\session_type.dart", "Dart", 30, 0, 3, 5, 38
"c:\Users\dunca\Documents\development\apps\sayari\lib\features\_calendar\session_view.dart", "Dart", 35, 0, 3, 5, 43
"c:\Users\dunca\Documents\development\apps\sayari\lib\features\_calendar\weekly\day_labels.dart", "Dart", 75, 0, 6, 5, 86
"c:\Users\dunca\Documents\development\apps\sayari\lib\features\_calendar\weekly\weekly.dart", "Dart", 133, 0, 12, 8, 153
"c:\Users\dunca\Documents\development\apps\sayari\lib\features\_calendar\yearly\month.dart", "Dart", 27, 0, 0, 5, 32
"c:\Users\dunca\Documents\development\apps\sayari\lib\features\_calendar\yearly\title.dart", "Dart", 32, 0, 0, 6, 38
"c:\Users\dunca\Documents\development\apps\sayari\lib\features\_calendar\yearly\yearly_view.dart", "Dart", 113, 0, 0, 8, 121
"c:\Users\dunca\Documents\development\apps\sayari\lib\features\_home\_helpers\change_view.dart", "Dart", 28, 0, 0, 4, 32
"c:\Users\dunca\Documents\development\apps\sayari\lib\features\_home\_helpers\nav.dart", "Dart", 4, 0, 0, 2, 6
"c:\Users\dunca\Documents\development\apps\sayari\lib\features\_home\_w\fab.dart", "Dart", 42, 0, 0, 5, 47
"c:\Users\dunca\Documents\development\apps\sayari\lib\features\_home\appbar.dart", "Dart", 69, 0, 8, 5, 82
"c:\Users\dunca\Documents\development\apps\sayari\lib\features\_home\appbar\space_name.dart", "Dart", 36, 0, 0, 5, 41
"c:\Users\dunca\Documents\development\apps\sayari\lib\features\_home\drawer\drawer.dart", "Dart", 23, 0, 0, 4, 27
"c:\Users\dunca\Documents\development\apps\sayari\lib\features\_home\drawer\drawer_end.dart", "Dart", 23, 0, 0, 4, 27
"c:\Users\dunca\Documents\development\apps\sayari\lib\features\_home\home.dart", "Dart", 52, 0, 1, 10, 63
"c:\Users\dunca\Documents\development\apps\sayari\lib\features\_home\layout.dart", "Dart", 80, 0, 9, 4, 93
"c:\Users\dunca\Documents\development\apps\sayari\lib\features\_home\navbars\nav_item.dart", "Dart", 28, 0, 0, 3, 31
"c:\Users\dunca\Documents\development\apps\sayari\lib\features\_home\navbars\nav_menu.dart", "Dart", 50, 0, 10, 5, 65
"c:\Users\dunca\Documents\development\apps\sayari\lib\features\_home\navbars\navbar_horizontal.dart", "Dart", 51, 0, 8, 4, 63
"c:\Users\dunca\Documents\development\apps\sayari\lib\features\_home\navbars\navbar_options.dart", "Dart", 35, 0, 0, 6, 41
"c:\Users\dunca\Documents\development\apps\sayari\lib\features\_home\navbars\navbar_vertical.dart", "Dart", 46, 0, 5, 5, 56
"c:\Users\dunca\Documents\development\apps\sayari\lib\features\_home\navbars\pinned_settings.dart", "Dart", 21, 0, 5, 3, 29
"c:\Users\dunca\Documents\development\apps\sayari\lib\features\_home\navbars\user_options.dart", "Dart", 67, 0, 8, 4, 79
"c:\Users\dunca\Documents\development\apps\sayari\lib\features\_home\panel\creator.dart", "Dart", 38, 0, 0, 5, 43
"c:\Users\dunca\Documents\development\apps\sayari\lib\features\_home\panel\panel.dart", "Dart", 81, 0, 8, 5, 94
"c:\Users\dunca\Documents\development\apps\sayari\lib\features\_home\panel\toggle.dart", "Dart", 22, 0, 0, 4, 26
"c:\Users\dunca\Documents\development\apps\sayari\lib\features\_notes\_helpers\chosen.dart", "Dart", 43, 0, 0, 9, 52
"c:\Users\dunca\Documents\development\apps\sayari\lib\features\_notes\_helpers\compare_data.dart", "Dart", 28, 0, 8, 8, 44
"c:\Users\dunca\Documents\development\apps\sayari\lib\features\_notes\_helpers\create_item.dart", "Dart", 58, 0, 6, 10, 74
"c:\Users\dunca\Documents\development\apps\sayari\lib\features\_notes\_helpers\delete_item.dart", "Dart", 26, 0, 1, 7, 34
"c:\Users\dunca\Documents\development\apps\sayari\lib\features\_notes\_helpers\edit_item.dart", "Dart", 83, 0, 9, 10, 102
"c:\Users\dunca\Documents\development\apps\sayari\lib\features\_notes\_helpers\helpers.dart", "Dart", 50, 0, 8, 9, 67
"c:\Users\dunca\Documents\development\apps\sayari\lib\features\_notes\_helpers\ontap.dart", "Dart", 32, 0, 1, 5, 38
"c:\Users\dunca\Documents\development\apps\sayari\lib\features\_notes\_helpers\order_items.dart", "Dart", 29, 0, 1, 7, 37
"c:\Users\dunca\Documents\development\apps\sayari\lib\features\_notes\_helpers\quick_edit.dart", "Dart", 43, 0, 1, 9, 53
"c:\Users\dunca\Documents\development\apps\sayari\lib\features\_notes\_helpers\validation.dart", "Dart", 40, 0, 1, 10, 51
"c:\Users\dunca\Documents\development\apps\sayari\lib\features\_notes\_w\footer.dart", "Dart", 23, 0, 2, 4, 29
"c:\Users\dunca\Documents\development\apps\sayari\lib\features\_notes\_w\new.dart", "Dart", 35, 0, 4, 4, 43
"c:\Users\dunca\Documents\development\apps\sayari\lib\features\_notes\_w\note_options.dart", "Dart", 57, 0, 5, 5, 67
"c:\Users\dunca\Documents\development\apps\sayari\lib\features\_notes\_w\option.dart", "Dart", 37, 0, 1, 6, 44
"c:\Users\dunca\Documents\development\apps\sayari\lib\features\_notes\_w\options_toggler.dart", "Dart", 58, 0, 2, 8, 68
"c:\Users\dunca\Documents\development\apps\sayari\lib\features\_notes\_w\text_overview.dart", "Dart", 31, 0, 0, 6, 37
"c:\Users\dunca\Documents\development\apps\sayari\lib\features\_notes\items\date.dart", "Dart", 103, 0, 10, 6, 119
"c:\Users\dunca\Documents\development\apps\sayari\lib\features\_notes\items\details.dart", "Dart", 34, 0, 6, 5, 45
"c:\Users\dunca\Documents\development\apps\sayari\lib\features\_notes\items\emoji.dart", "Dart", 57, 0, 5, 5, 67
"c:\Users\dunca\Documents\development\apps\sayari\lib\features\_notes\items\header.dart", "Dart", 62, 0, 16, 5, 83
"c:\Users\dunca\Documents\development\apps\sayari\lib\features\_notes\items\input_actions.dart", "Dart", 84, 0, 12, 5, 101
"c:\Users\dunca\Documents\development\apps\sayari\lib\features\_notes\items\input_actions_more.dart", "Dart", 77, 0, 7, 5, 89
"c:\Users\dunca\Documents\development\apps\sayari\lib\features\_notes\items\item_actions.dart", "Dart", 116, 0, 10, 6, 132
"c:\Users\dunca\Documents\development\apps\sayari\lib\features\_notes\items\item_selection.dart", "Dart", 228, 0, 38, 5, 271
"c:\Users\dunca\Documents\development\apps\sayari\lib\features\_notes\items\item_selection_more.dart", "Dart", 52, 0, 3, 5, 60
"c:\Users\dunca\Documents\development\apps\sayari\lib\features\_notes\items\last_edit.dart", "Dart", 20, 0, 0, 5, 25
"c:\Users\dunca\Documents\development\apps\sayari\lib\features\_notes\items\list_item.dart", "Dart", 53, 0, 8, 5, 66
"c:\Users\dunca\Documents\development\apps\sayari\lib\features\_notes\items\picker_type.dart", "Dart", 76, 0, 6, 7, 89
"c:\Users\dunca\Documents\development\apps\sayari\lib\features\_notes\items\pinned.dart", "Dart", 31, 0, 0, 6, 37
"c:\Users\dunca\Documents\development\apps\sayari\lib\features\_notes\items\published.dart", "Dart", 22, 0, 0, 5, 27
"c:\Users\dunca\Documents\development\apps\sayari\lib\features\_notes\items\selector.dart", "Dart", 74, 0, 0, 7, 81
"c:\Users\dunca\Documents\development\apps\sayari\lib\features\_notes\items\view.dart", "Dart", 9, 0, 0, 4, 13
"c:\Users\dunca\Documents\development\apps\sayari\lib\features\_notes\note.dart", "Dart", 101, 0, 14, 5, 120
"c:\Users\dunca\Documents\development\apps\sayari\lib\features\_notes\note_sheet.dart", "Dart", 82, 0, 11, 3, 96
"c:\Users\dunca\Documents\development\apps\sayari\lib\features\_notes\quill\editor.dart", "Dart", 40, 0, 1, 6, 47
"c:\Users\dunca\Documents\development\apps\sayari\lib\features\_notes\quill\editor_style.dart", "Dart", 200, 0, 0, 7, 207
"c:\Users\dunca\Documents\development\apps\sayari\lib\features\_notes\quill\embed_image.dart", "Dart", 47, 0, 0, 9, 56
"c:\Users\dunca\Documents\development\apps\sayari\lib\features\_notes\quill\image.dart", "Dart", 0, 0, 84, 17, 101
"c:\Users\dunca\Documents\development\apps\sayari\lib\features\_notes\quill\toolbar.dart", "Dart", 119, 0, 20, 5, 144
"c:\Users\dunca\Documents\development\apps\sayari\lib\features\_notes\type\bookings\_w\booking.dart", "Dart", 84, 0, 11, 6, 101
"c:\Users\dunca\Documents\development\apps\sayari\lib\features\_notes\type\bookings\_w\bookings_list.dart", "Dart", 190, 0, 15, 8, 213
"c:\Users\dunca\Documents\development\apps\sayari\lib\features\_notes\type\bookings\_w\copy_link.dart", "Dart", 35, 0, 1, 5, 41
"c:\Users\dunca\Documents\development\apps\sayari\lib\features\_notes\type\bookings\_w\date_times.dart", "Dart", 130, 0, 13, 6, 149
"c:\Users\dunca\Documents\development\apps\sayari\lib\features\_notes\type\bookings\_w\dialog_change_date.dart", "Dart", 130, 0, 11, 8, 149
"c:\Users\dunca\Documents\development\apps\sayari\lib\features\_notes\type\bookings\_w\header.dart", "Dart", 33, 0, 0, 6, 39
"c:\Users\dunca\Documents\development\apps\sayari\lib\features\_notes\type\bookings\_w\overview.dart", "Dart", 58, 0, 4, 5, 67
"c:\Users\dunca\Documents\development\apps\sayari\lib\features\_notes\type\bookings\_w_shared\body.dart", "Dart", 49, 0, 8, 6, 63
"c:\Users\dunca\Documents\development\apps\sayari\lib\features\_notes\type\bookings\_w_shared\booker.dart", "Dart", 156, 0, 12, 12, 180
"c:\Users\dunca\Documents\development\apps\sayari\lib\features\_notes\type\bookings\_w_shared\date.dart", "Dart", 96, 0, 6, 4, 106
"c:\Users\dunca\Documents\development\apps\sayari\lib\features\_notes\type\bookings\_w_shared\intro.dart", "Dart", 56, 0, 4, 6, 66
"c:\Users\dunca\Documents\development\apps\sayari\lib\features\_notes\type\bookings\_w_shared\time.dart", "Dart", 99, 0, 7, 5, 111
"c:\Users\dunca\Documents\development\apps\sayari\lib\features\_notes\type\finance\_helpers\calculations.dart", "Dart", 14, 0, 0, 5, 19
"c:\Users\dunca\Documents\development\apps\sayari\lib\features\_notes\type\finance\_helpers\helpers.dart", "Dart", 48, 0, 1, 10, 59
"c:\Users\dunca\Documents\development\apps\sayari\lib\features\_notes\type\finance\_vars\variables.dart", "Dart", 28, 0, 0, 3, 31
"c:\Users\dunca\Documents\development\apps\sayari\lib\features\_notes\type\finance\_w\add_entry.dart", "Dart", 76, 0, 9, 4, 89
"c:\Users\dunca\Documents\development\apps\sayari\lib\features\_notes\type\finance\_w\dialog_add_budget.dart", "Dart", 47, 0, 7, 4, 58
"c:\Users\dunca\Documents\development\apps\sayari\lib\features\_notes\type\finance\_w\dialog_add_entry.dart", "Dart", 106, 0, 17, 7, 130
"c:\Users\dunca\Documents\development\apps\sayari\lib\features\_notes\type\finance\_w\entries.dart", "Dart", 35, 0, 0, 7, 42
"c:\Users\dunca\Documents\development\apps\sayari\lib\features\_notes\type\finance\_w\entry.dart", "Dart", 92, 0, 8, 6, 106
"c:\Users\dunca\Documents\development\apps\sayari\lib\features\_notes\type\finance\_w\entry_filter.dart", "Dart", 49, 0, 5, 4, 58
"c:\Users\dunca\Documents\development\apps\sayari\lib\features\_notes\type\finance\_w\footer.dart", "Dart", 61, 0, 8, 4, 73
"c:\Users\dunca\Documents\development\apps\sayari\lib\features\_notes\type\finance\_w\goals.dart", "Dart", 87, 0, 4, 5, 96
"c:\Users\dunca\Documents\development\apps\sayari\lib\features\_notes\type\finance\_w\new_type.dart", "Dart", 62, 0, 6, 7, 75
"c:\Users\dunca\Documents\development\apps\sayari\lib\features\_notes\type\finance\_w\overview.dart", "Dart", 71, 0, 6, 4, 81
"c:\Users\dunca\Documents\development\apps\sayari\lib\features\_notes\type\finance\_w\toggler.dart", "Dart", 22, 0, 0, 5, 27
"c:\Users\dunca\Documents\development\apps\sayari\lib\features\_notes\type\finance\_w_graphs\bar.dart", "Dart", 254, 0, 0, 19, 273
"c:\Users\dunca\Documents\development\apps\sayari\lib\features\_notes\type\finance\_w_graphs\graph_menu.dart", "Dart", 8, 0, 0, 3, 11
"c:\Users\dunca\Documents\development\apps\sayari\lib\features\_notes\type\finance\_w_graphs\indicator.dart", "Dart", 27, 0, 0, 4, 31
"c:\Users\dunca\Documents\development\apps\sayari\lib\features\_notes\type\finance\_w_graphs\line.dart", "Dart", 326, 0, 0, 32, 358
"c:\Users\dunca\Documents\development\apps\sayari\lib\features\_notes\type\finance\_w_graphs\pie.dart", "Dart", 72, 0, 7, 9, 88
"c:\Users\dunca\Documents\development\apps\sayari\lib\features\_notes\type\finance\finance.dart", "Dart", 34, 0, 2, 4, 40
"c:\Users\dunca\Documents\development\apps\sayari\lib\features\_notes\type\finance\graphs_sheet.dart", "Dart", 63, 0, 7, 4, 74
"c:\Users\dunca\Documents\development\apps\sayari\lib\features\_notes\type\habits\checked_dates.dart", "Dart", 77, 0, 3, 6, 86
"c:\Users\dunca\Documents\development\apps\sayari\lib\features\_notes\type\habits\habit.dart", "Dart", 39, 0, 4, 5, 48
"c:\Users\dunca\Documents\development\apps\sayari\lib\features\_notes\type\habits\habit_options.dart", "Dart", 51, 0, 3, 5, 59
"c:\Users\dunca\Documents\development\apps\sayari\lib\features\_notes\type\habits\header.dart", "Dart", 52, 0, 8, 6, 66
"c:\Users\dunca\Documents\development\apps\sayari\lib\features\_notes\type\habits\month.dart", "Dart", 148, 0, 14, 9, 171
"c:\Users\dunca\Documents\development\apps\sayari\lib\features\_notes\type\habits\overview.dart", "Dart", 72, 0, 4, 9, 85
"c:\Users\dunca\Documents\development\apps\sayari\lib\features\_notes\type\habits\week.dart", "Dart", 167, 0, 26, 10, 203
"c:\Users\dunca\Documents\development\apps\sayari\lib\features\_notes\type\habits\year.dart", "Dart", 160, 0, 17, 9, 186
"c:\Users\dunca\Documents\development\apps\sayari\lib\features\_notes\type\links\_helpers\helpers.dart", "Dart", 17, 0, 1, 5, 23
"c:\Users\dunca\Documents\development\apps\sayari\lib\features\_notes\type\links\_w\add_link.dart", "Dart", 44, 0, 3, 4, 51
"c:\Users\dunca\Documents\development\apps\sayari\lib\features\_notes\type\links\_w\checked_dates.dart", "Dart", 81, 0, 3, 8, 92
"c:\Users\dunca\Documents\development\apps\sayari\lib\features\_notes\type\links\_w\header.dart", "Dart", 120, 0, 9, 6, 135
"c:\Users\dunca\Documents\development\apps\sayari\lib\features\_notes\type\links\_w\link_item.dart", "Dart", 241, 0, 22, 11, 274
"c:\Users\dunca\Documents\development\apps\sayari\lib\features\_notes\type\links\_w\links.dart", "Dart", 36, 0, 5, 4, 45
"c:\Users\dunca\Documents\development\apps\sayari\lib\features\_notes\type\links\_w\links_list.dart", "Dart", 59, 0, 4, 9, 72
"c:\Users\dunca\Documents\development\apps\sayari\lib\features\_notes\type\links\_w\overview.dart", "Dart", 58, 0, 4, 5, 67
"c:\Users\dunca\Documents\development\apps\sayari\lib\features\_notes\type\links\_w\username.dart", "Dart", 100, 0, 7, 8, 115
"c:\Users\dunca\Documents\development\apps\sayari\lib\features\_notes\type\links\_w_shared\intro.dart", "Dart", 65, 0, 8, 6, 79
"c:\Users\dunca\Documents\development\apps\sayari\lib\features\_notes\type\links\_w_shared\links_body.dart", "Dart", 108, 0, 11, 8, 127
"c:\Users\dunca\Documents\development\apps\sayari\lib\features\_notes\type\links\_w_shared\share_menu.dart", "Dart", 39, 0, 0, 5, 44
"c:\Users\dunca\Documents\development\apps\sayari\lib\features\_notes\type\tasks\_helpers\helper.dart", "Dart", 9, 0, 3, 4, 16
"c:\Users\dunca\Documents\development\apps\sayari\lib\features\_notes\type\tasks\_helpers\ontap.dart", "Dart", 17, 0, 1, 4, 22
"c:\Users\dunca\Documents\development\apps\sayari\lib\features\_notes\type\tasks\_w_item\delete_item_menu.dart", "Dart", 38, 0, 0, 5, 43
"c:\Users\dunca\Documents\development\apps\sayari\lib\features\_notes\type\tasks\_w_item\flag_list.dart", "Dart", 50, 0, 2, 7, 59
"c:\Users\dunca\Documents\development\apps\sayari\lib\features\_notes\type\tasks\_w_item\item_dialog.dart", "Dart", 116, 0, 22, 5, 143
"c:\Users\dunca\Documents\development\apps\sayari\lib\features\_notes\type\tasks\_w_item\item_flag.dart", "Dart", 56, 0, 4, 5, 65
"c:\Users\dunca\Documents\development\apps\sayari\lib\features\_notes\type\tasks\_w_item\new_item.dart", "Dart", 123, 0, 18, 7, 148
"c:\Users\dunca\Documents\development\apps\sayari\lib\features\_notes\type\tasks\_w_item\progress_bar.dart", "Dart", 61, 0, 6, 6, 73
"c:\Users\dunca\Documents\development\apps\sayari\lib\features\_notes\type\tasks\_w_item\subitem.dart", "Dart", 126, 0, 10, 8, 144
"c:\Users\dunca\Documents\development\apps\sayari\lib\features\_notes\type\tasks\subitems.dart", "Dart", 42, 0, 1, 8, 51
"c:\Users\dunca\Documents\development\apps\sayari\lib\features\_notes\type\tasks\task.dart", "Dart", 27, 0, 4, 4, 35
"c:\Users\dunca\Documents\development\apps\sayari\lib\features\_notes\type\tasks\task_options.dart", "Dart", 60, 0, 7, 5, 72
"c:\Users\dunca\Documents\development\apps\sayari\lib\features\_spaces\_helpers\add_space.dart", "Dart", 44, 0, 0, 4, 48
"c:\Users\dunca\Documents\development\apps\sayari\lib\features\_spaces\_helpers\admin_helpers.dart", "Dart", 81, 0, 0, 11, 92
"c:\Users\dunca\Documents\development\apps\sayari\lib\features\_spaces\_helpers\checks_space.dart", "Dart", 43, 0, 1, 8, 52
"c:\Users\dunca\Documents\development\apps\sayari\lib\features\_spaces\_helpers\common.dart", "Dart", 23, 0, 0, 5, 28
"c:\Users\dunca\Documents\development\apps\sayari\lib\features\_spaces\_helpers\create_space.dart", "Dart", 35, 0, 23, 6, 64
"c:\Users\dunca\Documents\development\apps\sayari\lib\features\_spaces\_helpers\delete_space.dart", "Dart", 75, 0, 27, 6, 108
"c:\Users\dunca\Documents\development\apps\sayari\lib\features\_spaces\_helpers\helpers.dart", "Dart", 24, 0, 0, 5, 29
"c:\Users\dunca\Documents\development\apps\sayari\lib\features\_spaces\_helpers\select_space.dart", "Dart", 27, 0, 6, 5, 38
"c:\Users\dunca\Documents\development\apps\sayari\lib\features\_spaces\_helpers\space_names.dart", "Dart", 42, 0, 3, 8, 53
"c:\Users\dunca\Documents\development\apps\sayari\lib\features\_spaces\manager\_w\creator_options.dart", "Dart", 70, 0, 7, 4, 81
"c:\Users\dunca\Documents\development\apps\sayari\lib\features\_spaces\manager\_w\dialog_add_space.dart", "Dart", 37, 0, 4, 4, 45
"c:\Users\dunca\Documents\development\apps\sayari\lib\features\_spaces\manager\_w\dialog_create_group.dart", "Dart", 27, 0, 0, 4, 31
"c:\Users\dunca\Documents\development\apps\sayari\lib\features\_spaces\manager\_w\group_list.dart", "Dart", 24, 0, 0, 7, 31
"c:\Users\dunca\Documents\development\apps\sayari\lib\features\_spaces\manager\_w\group_options.dart", "Dart", 26, 0, 2, 5, 33
"c:\Users\dunca\Documents\development\apps\sayari\lib\features\_spaces\manager\_w\group_tile.dart", "Dart", 28, 0, 0, 6, 34
"c:\Users\dunca\Documents\development\apps\sayari\lib\features\_spaces\manager\_w\space_list.dart", "Dart", 29, 0, 0, 7, 36
"c:\Users\dunca\Documents\development\apps\sayari\lib\features\_spaces\manager\_w\space_options.dart", "Dart", 78, 0, 6, 8, 92
"c:\Users\dunca\Documents\development\apps\sayari\lib\features\_spaces\manager\_w\space_tile.dart", "Dart", 87, 0, 10, 9, 106
"c:\Users\dunca\Documents\development\apps\sayari\lib\features\_spaces\manager\_w\tile.dart", "Dart", 56, 0, 0, 5, 61
"c:\Users\dunca\Documents\development\apps\sayari\lib\features\_spaces\manager\manager.dart", "Dart", 34, 0, 7, 5, 46
"c:\Users\dunca\Documents\development\apps\sayari\lib\features\_spaces\new_space\_w\description.dart", "Dart", 31, 0, 4, 4, 39
"c:\Users\dunca\Documents\development\apps\sayari\lib\features\_spaces\new_space\_w\group.dart", "Dart", 69, 0, 7, 5, 81
"c:\Users\dunca\Documents\development\apps\sayari\lib\features\_spaces\new_space\_w\header.dart", "Dart", 29, 0, 3, 5, 37
"c:\Users\dunca\Documents\development\apps\sayari\lib\features\_spaces\new_space\_w\title.dart", "Dart", 26, 0, 0, 5, 31
"c:\Users\dunca\Documents\development\apps\sayari\lib\features\_spaces\new_space\space_sheet.dart", "Dart", 36, 0, 15, 3, 54
"c:\Users\dunca\Documents\development\apps\sayari\lib\features\_spaces\overview\_w\admin_chip.dart", "Dart", 37, 0, 0, 5, 42
"c:\Users\dunca\Documents\development\apps\sayari\lib\features\_spaces\overview\_w\dialog_add_admin.dart", "Dart", 22, 0, 0, 4, 26
"c:\Users\dunca\Documents\development\apps\sayari\lib\features\_spaces\overview\_w\dialog_space_activity.dart", "Dart", 17, 0, 0, 3, 20
"c:\Users\dunca\Documents\development\apps\sayari\lib\features\_spaces\overview\_w\notification_item.dart", "Dart", 26, 0, 0, 5, 31
"c:\Users\dunca\Documents\development\apps\sayari\lib\features\_spaces\overview\_w\notifications.dart", "Dart", 40, 0, 9, 3, 52
"c:\Users\dunca\Documents\development\apps\sayari\lib\features\_spaces\overview\_w\space_about.dart", "Dart", 17, 0, 0, 5, 22
"c:\Users\dunca\Documents\development\apps\sayari\lib\features\_spaces\overview\_w\space_action_button.dart", "Dart", 29, 0, 0, 3, 32
"c:\Users\dunca\Documents\development\apps\sayari\lib\features\_spaces\overview\_w\space_activity_tile.dart", "Dart", 27, 0, 0, 4, 31
"c:\Users\dunca\Documents\development\apps\sayari\lib\features\_spaces\overview\_w\space_admin_tile.dart", "Dart", 28, 0, 0, 4, 32
"c:\Users\dunca\Documents\development\apps\sayari\lib\features\_spaces\overview\_w\space_name.dart", "Dart", 21, 0, 0, 4, 25
"c:\Users\dunca\Documents\development\apps\sayari\lib\features\_spaces\overview\_w\space_notfications_tile.dart", "Dart", 25, 0, 0, 5, 30
"c:\Users\dunca\Documents\development\apps\sayari\lib\features\_spaces\overview\_w\space_owner_tile.dart", "Dart", 42, 0, 0, 5, 47
"c:\Users\dunca\Documents\development\apps\sayari\lib\features\_spaces\overview\activity_sheet.dart", "Dart", 55, 0, 5, 4, 64
"c:\Users\dunca\Documents\development\apps\sayari\lib\features\_spaces\overview\admins_sheet.dart", "Dart", 76, 0, 8, 6, 90
"c:\Users\dunca\Documents\development\apps\sayari\lib\features\_spaces\overview\overview_sheet.dart", "Dart", 106, 0, 21, 5, 132
"c:\Users\dunca\Documents\development\apps\sayari\lib\features\_spaces\published\button.dart", "Dart", 51, 0, 3, 6, 60
"c:\Users\dunca\Documents\development\apps\sayari\lib\features\_spaces\published\cover.dart", "Dart", 49, 0, 1, 7, 57
"c:\Users\dunca\Documents\development\apps\sayari\lib\features\_spaces\published\details.dart", "Dart", 132, 0, 14, 7, 153
"c:\Users\dunca\Documents\development\apps\sayari\lib\features\_spaces\published\shared.dart", "Dart", 61, 0, 3, 5, 69
"c:\Users\dunca\Documents\development\apps\sayari\lib\features\_spaces\published\shared_intro.dart", "Dart", 63, 0, 4, 5, 72
"c:\Users\dunca\Documents\development\apps\sayari\lib\features\ai\_helpers\helpers.dart", "Dart", 0, 0, 0, 2, 2
"c:\Users\dunca\Documents\development\apps\sayari\lib\features\ai\_helpers\prompt.dart", "Dart", 1, 0, 0, 1, 2
"c:\Users\dunca\Documents\development\apps\sayari\lib\features\ai\ai_bar.dart", "Dart", 51, 0, 0, 4, 55
"c:\Users\dunca\Documents\development\apps\sayari\lib\features\ai\ai_btn.dart", "Dart", 21, 0, 0, 4, 25
"c:\Users\dunca\Documents\development\apps\sayari\lib\features\ai\ai_sheet.dart", "Dart", 21, 0, 5, 3, 29
"c:\Users\dunca\Documents\development\apps\sayari\lib\features\auth\_helpers\anonymous.dart", "Dart", 4, 0, 3, 2, 9
"c:\Users\dunca\Documents\development\apps\sayari\lib\features\auth\_helpers\apple.dart", "Dart", 2, 0, 28, 8, 38
"c:\Users\dunca\Documents\development\apps\sayari\lib\features\auth\_helpers\auth_error_handler.dart", "Dart", 55, 0, 13, 6, 74
"c:\Users\dunca\Documents\development\apps\sayari\lib\features\auth\_helpers\email_signin.dart", "Dart", 37, 0, 4, 5, 46
"c:\Users\dunca\Documents\development\apps\sayari\lib\features\auth\_helpers\email_signup.dart", "Dart", 48, 0, 10, 5, 63
"c:\Users\dunca\Documents\development\apps\sayari\lib\features\auth\_helpers\google.dart", "Dart", 15, 0, 8, 10, 33
"c:\Users\dunca\Documents\development\apps\sayari\lib\features\auth\_helpers\reset_password.dart", "Dart", 25, 0, 0, 3, 28
"c:\Users\dunca\Documents\development\apps\sayari\lib\features\auth\_helpers\sign_out.dart", "Dart", 13, 0, 0, 3, 16
"c:\Users\dunca\Documents\development\apps\sayari\lib\features\auth\_helpers\user_details_helper.dart", "Dart", 17, 0, 0, 4, 21
"c:\Users\dunca\Documents\development\apps\sayari\lib\features\auth\auth_screen.dart", "Dart", 295, 0, 29, 16, 340
"c:\Users\dunca\Documents\development\apps\sayari\lib\features\auth\button.dart", "Dart", 45, 0, 2, 5, 52
"c:\Users\dunca\Documents\development\apps\sayari\lib\features\auth\intro.dart", "Dart", 53, 0, 2, 5, 60
"c:\Users\dunca\Documents\development\apps\sayari\lib\features\ble\ble_service.dart", "Dart", 80, 0, 7, 11, 98
"c:\Users\dunca\Documents\development\apps\sayari\lib\features\ble\device.dart", "Dart", 68, 0, 9, 9, 86
"c:\Users\dunca\Documents\development\apps\sayari\lib\features\ble\filter_devices.dart", "Dart", 16, 0, 0, 5, 21
"c:\Users\dunca\Documents\development\apps\sayari\lib\features\ble\permissions.dart", "Dart", 6, 0, 0, 2, 8
"c:\Users\dunca\Documents\development\apps\sayari\lib\features\chat\_helpers\helpers.dart", "Dart", 20, 0, 1, 5, 26
"c:\Users\dunca\Documents\development\apps\sayari\lib\features\chat\_helpers\send_message.dart", "Dart", 33, 0, 0, 5, 38
"c:\Users\dunca\Documents\development\apps\sayari\lib\features\chat\_helpers\update_chat.dart", "Dart", 16, 0, 0, 6, 22
"c:\Users\dunca\Documents\development\apps\sayari\lib\features\chat\_w\options.dart", "Dart", 27, 0, 11, 4, 42
"c:\Users\dunca\Documents\development\apps\sayari\lib\features\chat\_w\options_btn.dart", "Dart", 26, 0, 0, 5, 31
"c:\Users\dunca\Documents\development\apps\sayari\lib\features\chat\_w\pinned.dart", "Dart", 45, 0, 1, 6, 52
"c:\Users\dunca\Documents\development\apps\sayari\lib\features\chat\_w\send_btn.dart", "Dart", 24, 0, 0, 5, 29
"c:\Users\dunca\Documents\development\apps\sayari\lib\features\chat\bubbles\incoming.dart", "Dart", 81, 0, 9, 5, 95
"c:\Users\dunca\Documents\development\apps\sayari\lib\features\chat\bubbles\sent.dart", "Dart", 81, 0, 10, 6, 97
"c:\Users\dunca\Documents\development\apps\sayari\lib\features\chat\chat_view.dart", "Dart", 84, 0, 6, 8, 98
"c:\Users\dunca\Documents\development\apps\sayari\lib\features\chat\input_bar.dart", "Dart", 97, 0, 8, 6, 111
"c:\Users\dunca\Documents\development\apps\sayari\lib\features\code\_blocks\block.dart", "Dart", 98, 0, 10, 5, 113
"c:\Users\dunca\Documents\development\apps\sayari\lib\features\code\_blocks\delay.dart", "Dart", 40, 0, 6, 5, 51
"c:\Users\dunca\Documents\development\apps\sayari\lib\features\code\_blocks\if.dart", "Dart", 110, 0, 14, 9, 133
"c:\Users\dunca\Documents\development\apps\sayari\lib\features\code\_blocks\led_pin.dart", "Dart", 75, 0, 8, 8, 91
"c:\Users\dunca\Documents\development\apps\sayari\lib\features\code\_blocks\pin_state.dart", "Dart", 62, 0, 6, 8, 76
"c:\Users\dunca\Documents\development\apps\sayari\lib\features\code\_helpers\create_file.dart", "Dart", 27, 0, 0, 3, 30
"c:\Users\dunca\Documents\development\apps\sayari\lib\features\code\_helpers\delete_file.dart", "Dart", 10, 0, 0, 2, 12
"c:\Users\dunca\Documents\development\apps\sayari\lib\features\code\_vars\descriptions.dart", "Dart", 17, 0, 0, 1, 18
"c:\Users\dunca\Documents\development\apps\sayari\lib\features\code\_w\code_file_options.dart", "Dart", 39, 0, 4, 5, 48
"c:\Users\dunca\Documents\development\apps\sayari\lib\features\code\_w\code_files_list.dart", "Dart", 64, 0, 0, 7, 71
"c:\Users\dunca\Documents\development\apps\sayari\lib\features\code\_w\code_selector.dart", "Dart", 43, 0, 0, 4, 47
"c:\Users\dunca\Documents\development\apps\sayari\lib\features\code\_w\dialog_create_code.dart", "Dart", 30, 0, 0, 4, 34
"c:\Users\dunca\Documents\development\apps\sayari\lib\features\code\_w\widgets.dart", "Dart", 38, 0, 4, 5, 47
"c:\Users\dunca\Documents\development\apps\sayari\lib\features\code\block_chooser.dart", "Dart", 27, 0, 3, 6, 36
"c:\Users\dunca\Documents\development\apps\sayari\lib\features\code\block_description.dart", "Dart", 25, 0, 2, 5, 32
"c:\Users\dunca\Documents\development\apps\sayari\lib\features\code\code_blocks.dart", "Dart", 28, 0, 2, 4, 34
"c:\Users\dunca\Documents\development\apps\sayari\lib\features\code\code_sheet.dart", "Dart", 35, 0, 5, 3, 43
"c:\Users\dunca\Documents\development\apps\sayari\lib\features\code\code_view.dart", "Dart", 70, 0, 14, 6, 90
"c:\Users\dunca\Documents\development\apps\sayari\lib\features\code\repeat.dart", "Dart", 37, 0, 0, 5, 42
"c:\Users\dunca\Documents\development\apps\sayari\lib\features\error\error_screen.dart", "Dart", 85, 0, 3, 4, 92
"c:\Users\dunca\Documents\development\apps\sayari\lib\features\explore\explore_box.dart", "Dart", 51, 0, 5, 5, 61
"c:\Users\dunca\Documents\development\apps\sayari\lib\features\explore\explore_sheet.dart", "Dart", 50, 0, 8, 3, 61
"c:\Users\dunca\Documents\development\apps\sayari\lib\features\files\_helpers\download.dart", "Dart", 111, 0, 13, 10, 134
"c:\Users\dunca\Documents\development\apps\sayari\lib\features\files\_helpers\dp.dart", "Dart", 80, 0, 12, 6, 98
"c:\Users\dunca\Documents\development\apps\sayari\lib\features\files\_helpers\handler.dart", "Dart", 52, 0, 12, 5, 69
"c:\Users\dunca\Documents\development\apps\sayari\lib\features\files\_helpers\helper.dart", "Dart", 42, 0, 1, 10, 53
"c:\Users\dunca\Documents\development\apps\sayari\lib\features\files\_helpers\pdf.dart", "Dart", 0, 0, 12, 2, 14
"c:\Users\dunca\Documents\development\apps\sayari\lib\features\files\_helpers\upload.dart", "Dart", 48, 0, 6, 9, 63
"c:\Users\dunca\Documents\development\apps\sayari\lib\features\files\_vars\variables.dart", "Dart", 24, 0, 0, 2, 26
"c:\Users\dunca\Documents\development\apps\sayari\lib\features\files\file.dart", "Dart", 45, 0, 8, 8, 61
"c:\Users\dunca\Documents\development\apps\sayari\lib\features\files\file_list.dart", "Dart", 101, 0, 8, 8, 117
"c:\Users\dunca\Documents\development\apps\sayari\lib\features\files\image.dart", "Dart", 153, 0, 16, 11, 180
"c:\Users\dunca\Documents\development\apps\sayari\lib\features\files\image_extended.dart", "Dart", 106, 0, 15, 9, 130
"c:\Users\dunca\Documents\development\apps\sayari\lib\features\files\options.dart", "Dart", 42, 0, 4, 6, 52
"c:\Users\dunca\Documents\development\apps\sayari\lib\features\files\overview.dart", "Dart", 132, 0, 4, 8, 144
"c:\Users\dunca\Documents\development\apps\sayari\lib\features\files\viewer.dart", "Dart", 260, 0, 21, 17, 298
"c:\Users\dunca\Documents\development\apps\sayari\lib\features\flags\_helpers\delete_flag.dart", "Dart", 14, 0, 0, 3, 17
"c:\Users\dunca\Documents\development\apps\sayari\lib\features\flags\_helpers\edit_flag.dart", "Dart", 17, 0, 0, 4, 21
"c:\Users\dunca\Documents\development\apps\sayari\lib\features\flags\_helpers\manage_flag.dart", "Dart", 42, 0, 0, 8, 50
"c:\Users\dunca\Documents\development\apps\sayari\lib\features\flags\flag.dart", "Dart", 156, 0, 14, 11, 181
"c:\Users\dunca\Documents\development\apps\sayari\lib\features\flags\flags_menu.dart", "Dart", 87, 0, 8, 10, 105
"c:\Users\dunca\Documents\development\apps\sayari\lib\features\labels\_helpers\add_label.dart", "Dart", 20, 0, 10, 4, 34
"c:\Users\dunca\Documents\development\apps\sayari\lib\features\labels\_helpers\delete_label.dart", "Dart", 18, 0, 1, 4, 23
"c:\Users\dunca\Documents\development\apps\sayari\lib\features\labels\label.dart", "Dart", 99, 0, 3, 8, 110
"c:\Users\dunca\Documents\development\apps\sayari\lib\features\labels\list_of_labels.dart", "Dart", 70, 0, 2, 9, 81
"c:\Users\dunca\Documents\development\apps\sayari\lib\features\labels\manager.dart", "Dart", 113, 0, 9, 9, 131
"c:\Users\dunca\Documents\development\apps\sayari\lib\features\labels\menu.dart", "Dart", 16, 0, 3, 3, 22
"c:\Users\dunca\Documents\development\apps\sayari\lib\features\labels\new_label.dart", "Dart", 87, 0, 6, 7, 100
"c:\Users\dunca\Documents\development\apps\sayari\lib\features\labels\selector.dart", "Dart", 35, 0, 0, 4, 39
"c:\Users\dunca\Documents\development\apps\sayari\lib\features\pomodoro\_helpers\helpers.dart", "Dart", 79, 0, 5, 19, 103
"c:\Users\dunca\Documents\development\apps\sayari\lib\features\pomodoro\_helpers\save_settings.dart", "Dart", 26, 0, 1, 5, 32
"c:\Users\dunca\Documents\development\apps\sayari\lib\features\pomodoro\_w\pause_play_btn.dart", "Dart", 28, 0, 0, 5, 33
"c:\Users\dunca\Documents\development\apps\sayari\lib\features\pomodoro\_w\pomo_indicator.dart", "Dart", 34, 0, 0, 5, 39
"c:\Users\dunca\Documents\development\apps\sayari\lib\features\pomodoro\_w_settings\alarm_chooser.dart", "Dart", 24, 0, 2, 4, 30
"c:\Users\dunca\Documents\development\apps\sayari\lib\features\pomodoro\_w_settings\setting.dart", "Dart", 73, 0, 11, 5, 89
"c:\Users\dunca\Documents\development\apps\sayari\lib\features\pomodoro\_w_settings\settings_dialog.dart", "Dart", 71, 0, 14, 5, 90
"c:\Users\dunca\Documents\development\apps\sayari\lib\features\pomodoro\chooser.dart", "Dart", 36, 0, 6, 4, 46
"c:\Users\dunca\Documents\development\apps\sayari\lib\features\pomodoro\counter.dart", "Dart", 88, 0, 9, 6, 103
"c:\Users\dunca\Documents\development\apps\sayari\lib\features\pomodoro\sheet.dart", "Dart", 45, 0, 6, 3, 54
"c:\Users\dunca\Documents\development\apps\sayari\lib\features\pomodoro\type.dart", "Dart", 34, 0, 0, 6, 40
"c:\Users\dunca\Documents\development\apps\sayari\lib\features\reminders\_helpers\helper.dart", "Dart", 22, 0, 0, 5, 27
"c:\Users\dunca\Documents\development\apps\sayari\lib\features\reminders\_helpers\register_reminder.dart", "Dart", 59, 0, 13, 7, 79
"c:\Users\dunca\Documents\development\apps\sayari\lib\features\reminders\_helpers\reminders.dart", "Dart", 37, 0, 0, 6, 43
"c:\Users\dunca\Documents\development\apps\sayari\lib\features\reminders\reminder.dart", "Dart", 80, 0, 3, 8, 91
"c:\Users\dunca\Documents\development\apps\sayari\lib\features\reminders\reminder_menu.dart", "Dart", 153, 0, 19, 11, 183
"c:\Users\dunca\Documents\development\apps\sayari\lib\features\saved\_helpers\helpers.dart", "Dart", 0, 0, 0, 2, 2
"c:\Users\dunca\Documents\development\apps\sayari\lib\features\saved\_w\misc.dart", "Dart", 0, 0, 0, 2, 2
"c:\Users\dunca\Documents\development\apps\sayari\lib\features\saved\saved_sheet.dart", "Dart", 31, 0, 5, 3, 39
"c:\Users\dunca\Documents\development\apps\sayari\lib\features\search\_helpers\helpers.dart", "Dart", 0, 0, 0, 2, 2
"c:\Users\dunca\Documents\development\apps\sayari\lib\features\search\_helpers\search.dart", "Dart", 1, 0, 0, 1, 2
"c:\Users\dunca\Documents\development\apps\sayari\lib\features\search\search_bar.dart", "Dart", 53, 0, 0, 5, 58
"c:\Users\dunca\Documents\development\apps\sayari\lib\features\search\search_btn.dart", "Dart", 21, 0, 0, 4, 25
"c:\Users\dunca\Documents\development\apps\sayari\lib\features\search\search_sheet.dart", "Dart", 22, 0, 5, 4, 31
"c:\Users\dunca\Documents\development\apps\sayari\lib\features\settings\_w\account_details.dart", "Dart", 47, 0, 10, 4, 61
"c:\Users\dunca\Documents\development\apps\sayari\lib\features\settings\_w\account_support.dart", "Dart", 39, 0, 6, 4, 49
"c:\Users\dunca\Documents\development\apps\sayari\lib\features\settings\_w\reset_password.dart", "Dart", 43, 0, 5, 4, 52
"c:\Users\dunca\Documents\development\apps\sayari\lib\features\settings\_w\theme_settings.dart", "Dart", 36, 0, 4, 4, 44
"c:\Users\dunca\Documents\development\apps\sayari\lib\features\settings\_w\title.dart", "Dart", 20, 0, 0, 5, 25
"c:\Users\dunca\Documents\development\apps\sayari\lib\features\settings\edit_details.dart", "Dart", 69, 0, 15, 4, 88
"c:\Users\dunca\Documents\development\apps\sayari\lib\features\settings\settings_sheet.dart", "Dart", 41, 0, 10, 3, 54
"c:\Users\dunca\Documents\development\apps\sayari\lib\features\share\_helpers\helpers.dart", "Dart", 14, 0, 0, 2, 16
"c:\Users\dunca\Documents\development\apps\sayari\lib\features\share\_helpers\share.dart", "Dart", 50, 0, 4, 2, 56
"c:\Users\dunca\Documents\development\apps\sayari\lib\features\share\_w\actions.dart", "Dart", 59, 0, 4, 6, 69
"c:\Users\dunca\Documents\development\apps\sayari\lib\features\share\_w\blog_body.dart", "Dart", 56, 0, 8, 6, 70
"c:\Users\dunca\Documents\development\apps\sayari\lib\features\share\_w\blog_info.dart", "Dart", 44, 0, 9, 6, 59
"c:\Users\dunca\Documents\development\apps\sayari\lib\features\share\_w\header.dart", "Dart", 51, 0, 3, 5, 59
"c:\Users\dunca\Documents\development\apps\sayari\lib\features\share\_w\preview.dart", "Dart", 37, 0, 0, 5, 42
"c:\Users\dunca\Documents\development\apps\sayari\lib\features\share\_w\shared_info.dart", "Dart", 53, 0, 0, 5, 58
"c:\Users\dunca\Documents\development\apps\sayari\lib\features\share\shared_item.dart", "Dart", 134, 0, 9, 5, 148
"c:\Users\dunca\Documents\development\apps\sayari\lib\features\share\shared_screen.dart", "Dart", 112, 0, 3, 10, 125
"c:\Users\dunca\Documents\development\apps\sayari\lib\features\share\test_screen.dart", "Dart", 32, 0, 0, 5, 37
"c:\Users\dunca\Documents\development\apps\sayari\lib\features\tts\_helpers\tts_helpers.dart", "Dart", 17, 0, 0, 3, 20
"c:\Users\dunca\Documents\development\apps\sayari\lib\features\tts\_helpers\tts_service.dart", "Dart", 44, 0, 0, 10, 54
"c:\Users\dunca\Documents\development\apps\sayari\lib\features\tts\_state\tts_provider.dart", "Dart", 23, 0, 6, 9, 38
"c:\Users\dunca\Documents\development\apps\sayari\lib\features\tts\_w\tts_button.dart", "Dart", 27, 0, 0, 5, 32
"c:\Users\dunca\Documents\development\apps\sayari\lib\features\tts\_w\tts_controls.dart", "Dart", 41, 0, 6, 6, 53
"c:\Users\dunca\Documents\development\apps\sayari\lib\features\user\_helpers\edit_user_details.dart", "Dart", 60, 0, 0, 9, 69
"c:\Users\dunca\Documents\development\apps\sayari\lib\features\user\_helpers\saved.dart", "Dart", 39, 0, 0, 4, 43
"c:\Users\dunca\Documents\development\apps\sayari\lib\features\user\_helpers\set_user_data.dart", "Dart", 13, 0, 3, 7, 23
"c:\Users\dunca\Documents\development\apps\sayari\lib\features\user\_helpers\user_actions.dart", "Dart", 119, 0, 16, 19, 154
"c:\Users\dunca\Documents\development\apps\sayari\lib\features\user\dp_options.dart", "Dart", 21, 0, 5, 3, 29
"c:\Users\dunca\Documents\development\apps\sayari\lib\features\user\user_dp.dart", "Dart", 124, 0, 4, 9, 137
"c:\Users\dunca\Documents\development\apps\sayari\lib\firebase_options.dart", "Dart", 63, 0, 12, 5, 80
"c:\Users\dunca\Documents\development\apps\sayari\lib\main.dart", "Dart", 53, 0, 1, 9, 63
"Total", "-", 27317, 13, 3413, 3366, 34109